$^遠いところありがとうね、(.+?)くん。$	먼 곳까지 와줘서 고마워요, $1군.
$^今日、(.+?)くんを呼び出したのは他でも無い。$	오늘, $1군을 호출한 것은 다른게 아니라.
$^もし引き受けてくれたら、このエンパイアクラブだけではなく、(.+?)くんの専属メイドをつけてあげるよ。$	만약 맡아 주면, 이 엠파이어 클럽 만이 아니고, $1군의 전속 메이드를 붙여 준다.
$^その超高級なクラブと、凄く綺麗な女性が(.+?)くんのものになる。$	그 초고급 클럽과 굉장히 예쁜 여성이 $1군의 것이 된다.
$^そんな日々を、(.+?)くんにも味わって欲しいのだけれども……$	그런 나날을, $1군에게도 맛보았으면 좋은 것 만……
$^悪い話じゃない、(.+?)くん、さぁ。$	나쁜 이야기가 아니다, $1군, 자.
$^ああ、どうかなメイド長。(.+?)は立派なメイドに育ったかな？$	아아, 어때 메이드장. $1는 훌륭한 메이드로 성장한걸까?
$^(.+?)はメイド長の話を黙って聞いていた。$	$1는 메이드장의 이야기를 가만히 듣고 있었다.
$^(.+?)は健気にも、そう言ってくれる。$	$1는 기특하게도, 그렇게 말해 준다.
$^……(.+?)を、『専属メイド』として残らせる方法は無いかな？$	……$1를 『 전속 메이드 』로 남기는 방법은 없을까?
$^このまま(.+?)だけに無理をさせるなんて、そんな事はしたくなかった。$	이대로 $1에게 무리를 시킨다니 그런 일은 하고 싶지 않았다.
$^もし、(.+?)を我慢させるほうを選んでも、ずっとその事って俺は引き摺ると思うんだ。$	만약, $1를 참게 하는 편을 선택해도, 쭉 그 일은 나는 질질 끈다고 생각한다.
$^ああ、(.+?)、メイド長……これからもよろしくな。$	아아, $1, 메이드장…… 앞으로도 잘 부탁해.
$^(.+?)には悪いけど、『Ｆｒｅｅメイド』として諦めてもらおう。$	$1에는 안됐지만, 『프리 메이드』로서 단념해 주자.
$^それに、メイドがお客様にそういった接待をするのは、(.+?)だって理解しているだろうし。$	게다가, 메이드가 손님에 그렇게 말한 접대를 하는 것은, $1도 이해하고 있을 것이고.
$^ごめんね(.+?)。Ｆｒｅｅメイドとして働いてくれると嬉しいな。$	미안해 $1. Free 메이드로서 일해주면 좋겠어.
$^(.+?)がＦｒｅｅメイドとして働くだけで大丈夫なの？$	$1가 Free 메이드로서 일하는 것 만으로 괜찮은 거야?
$^(.+?)には悪いけれど、仕方の無い事だ。$	$1에게는 나쁘지만, 다른 방도가 없어.
$^ああ、どうかなメイド秘書。(.+?)は立派なメイドに育ったかな？$	아아, 어떨까 메이드 비서. $1는 훌륭한 메이드로 자랐어?
$^本格的な経営を始める為の資金が無いと、(.+?)を『専属メイド』にできない……$	본격적인 경영을 시작하기 위한 자금이 없으면 $1를 『전속 메이드』로 할 수 없다……
$^……(.+?)を『Ｆｒｅｅメイド』にすれば、その為の資金は用意できるんだね。$	…… $1를 『프리 메이드』로 하면, 이를 위한 자금은 준비할 수 있는 것이다.
$^(.+?)はメイド秘書の話を黙って聞いていた。$	$1는 메이드 비서의 이야기를 입 다물고 듣고 있었다.
$^(.+?)は強がって、そう言ってくれる。$	$1는 강한척 하면서 그렇게 말해준다.
$^俺は、(.+?)の事を……$	나는, $1의 일을……
$^それで(.+?)を『Ｆｒｅｅメイド』をせずに済むって事か。$	그래서 $1를 『프리 메이드』로 하지 않겠다는 것이군요.
$^ああ、(.+?)、メイド秘書……これからもよろしくな。$	아아, $1, 메이드 비서……앞으로도 아무쪼록.
$^そう言う(.+?)は、ほっとしたような微笑みを浮かべていた。$	그렇게 말하는 $1는 안심한 듯한 미소를 짓고 있었다.
$^どんとこいだよ、(.+?)。$	심쿵한거야, $1.
$^やぁ、(.+?)くん。$	이야, $1군.
$^はっはっは、そう怒らないでくれよ。今日は(.+?)くんに良い話を聞かせてあげようと思って電話をかけたんだから。$	하하하, 그렇게 화내지 말아줘. 오늘은 $1군에게 좋은 이야기를 들려주려고 생각해서 전화를 걸었으니까.
$^たしかに(.+?)と楽しく過ごせているが、エンパイアクラブの再建も行わなくてはならない。$	분명히 $1와 즐겁게 보내고 있겠지만, 엠파이어 클럽의 재건도 하지 않으면 안 된다.
$^彼女は将来有望だと思うが何分まだ新人だ。(.+?)同様、しっかり育ててあげるんだぞ。$	그녀는 장래가 유망하다고 생각하지만 아직은 신인이다. $1같이 확실히 길러 줘.
$^それじゃあね、(.+?)くん。体には気をつけるんだぞ。$	그럼, $1군. 몸조심하고.
$^突然言い渡された、(.+?)とは違うもう一人のメイドの存在。叔父さん曰く将来有望……だけど新人。$	돌연 선고받은, $1와는 다른 또 한사람의 메이드의 존재. 삼촌이 말하길 장래가 유망…… 하지만 신인.
$^まぁ、こういうのはなるようにしかならないか。案外(.+?)のように俺の理想がつまったようなメイドが来てくれるかもしれない。$	뭐, 이런 것은 할 수 밖에 없지 않을까. 의외로 $1와 같이 나의 이상형인 메이드가 와 줄지도 모른다.
$^別に、格好つけるわけでもなく本当にそう思う。ただ俺は、(.+?)やみんなのサポートに徹しただけだ。$	별로, 폼잡는 게 아니라 정말로 그렇게 생각해. 다만 나는, $1나 모두의 지원에 충실했을 뿐이야.
$^本当に良く頑張ってくれたね、(.+?)。\1は俺の誇りだよ。$	정말로 많이 노력해줬어, $1. $1는 나의 자랑이야.
$^冗談交じりに、(.+?)にそう言う。$	농담으로, $1에게 그렇게 말한다.
$^しっかり、真っ直ぐに俺を見つめて(.+?)はそう言ってくれる。$	확실히, 똑바로 나를 쳐다보고 $1는 그렇게 말해 주었다.
$^当たり前だよ、(.+?)こそずっと俺のメイドでいてくれよ？$	당연한 거라고. $1야 말로 앞으로도 계속 나의 메이드로 있어 줄래?
$^(.+?)……ずっと俺のメイドでいてくれよ？$	$1……쭉 나의 메이드로 있어줘?
$^ちょっとだけ恥ずかしい俺の言葉に、(.+?)は当然よ、に頷く。$	조금 부끄러운 나의 말에 $1는 당연한 듯이 고개를 끄덕인다.
$^ちょっとだけ恥ずかしい俺の言葉に、(.+?)は撫子のように微笑んだ。$	조금 부끄러운 나의 말에, $1는 패랭이꽃과 같이 미소지었다.
$^(.+?)は順調にメイドとして成長してきている。$	$1은 순조롭게 메이드로 성장하고 있다.
$^教養を得させる為に、(.+?)に新しいメニューをやらせてみる事にする。$	교양을 얻게 하기 위해 $1에 새로운 메뉴를 시켜보기로 했다.
$^これで(.+?)は読書によって、色々な刺激を得る事ができるだろう。$	이걸로 $1는 독서에 의해서 여러가지 자극을 얻을 수 있을 것이다.
$^俺は(.+?)に自分でメイクをさせる事にする。$	나는 $1에게 스스로 화장을 하도록 시켰다.
$^(.+?)の昼間のメニューに、俺はエステを加える事にした。$	나는 $1의 오전 스케줄에 에스테를 추가하기로 했다.
$^エステティシャンのテクニックによって、(.+?)の可憐さと魅惑にさらに磨きがかかるだろう。$	에스테티션의 테크닉에 의해서 $1의 가련함과 매혹이 더 세련되어질 것이다.
$^はは、俺は魅力的な(.+?)と話したいんだよ。$	하하, 나는 매력적인 $1이라고 말하고 싶어.
$^うーん……(.+?)に実はそんな一面があったらなぁって……まぁ男の妄想だよ、ごめんね？$	음…… $1에 사실 그런 면이 있었으면 하는…… 뭐, 남자의 망상이야. 미안해?
$^(.+?)も遠慮しなくていいんだよ？$	$1도 사양하지 않아도 된다구?
$^俺は、まぁ……(.+?)の胸は好きだよ？$	나는 뭐……$1의 가슴은 좋아한다구?
$^そうだね……でも、エッチだね、(.+?)。$	그러네…… 그래도 야하네, $1.
$^ああ、うん……俺もなんだかドキドキしてきたよ、(.+?)。$	아아, 응…… 나도 뭔가 두근두근하기 시작했어, $1.
$^ご主人様としては、(.+?)の好みは気になるなぁ……$	주인님으로서는, $1의 취향이 신경쓰이는데……
$^いや……はは、思ったよりエッチで可愛いね、(.+?)。$	아니…… 하하, 생각했던 것보다 야하고 귀엽네, $1.
$^(.+?)は、思ったよりエッチで素敵なんだね。$	$1는, 생각보다 야하고 멋지네.
$^あぁ、そうだ。エンパイアクラブから、(.+?)への衣装が届いていたな。$	아, 맞다. 엠파이어 클럽으로부터, $1에의 의상이 도착해 있었지.
$^とても似合ってるよ、(.+?)。$	너무 잘 어울리네, $1.
$^安心したような(.+?)を見ながら、俺は面接を終えるのだった。$	안심한 것 같은 $1을 보면서 나는 면접을 끝내는 것이었다.
$^おちんちんの事に決まってるだろ？　(.+?)にそんな風に現れたら、すぐにガチガチに勃起するだろうし……$	자지인 게 당연하잖아? $1가 그런식으로 나타나면 바로 딱딱하게 발기할테고……
$^現にいまだって、エッチな格好をしている(.+?)を見ていたら……ちょっと苦しいかな。$	실제로 지금도 야한 모습을하고있는 $1를 보고 있으면 …… 조금 괴롭다고 할까.
$^へぇ、(.+?)は大胆なんだね。$	헤에, $1는 대담하구나.
$^そうなんだ、お客様にされちゃう事もあるかもしれないけど……(.+?)のファーストキスの相手は、多分俺になるかな。$	그러네. 손님에게 당하게 될 지도 모르지만…… $1의 퍼스트 키스 상대는 아마도 내가 될 걸.
$^(.+?)みたいな魅力的な女性を抱く事になったら、たぶん俺は勝手に好きだって言葉が出てくるだろうけどね。$	$1같이 매력적인 여성을 품게 되면, 아마도 나는 멋대로 좋아한다는 말이 나오게 되겠지.
$^ひょっとして、(.+?)ってチョロい？$	혹시, $1는 쉬운여자?
$^ふふ、(.+?)は大胆だね……ねえ、どんな風なエッチにするの？$	후후, $1는 대담하네……저기, 어떤 식으로 음란하게 하는 거야?
$^(.+?)ってサドなの？$	$1는 사디스트야?
$^えっと、ひょっとしてって感じで聞くんだけどさ、(.+?)ってひょっとして普通におまんこでした事無い……とか？$	음, 혹시나 해서 물어보는 건데 말야. $1는 혹시 평범하게 보지로 해 본 적이 없다……라는 거야?
$^はぁ、なるほどな……随分変わってるね、(.+?)って……$	하아, 그렇구나…… 꽤나 특이하네, $1는……
$^あれ、返事が無いな、(.+?)……？$	어라, 대답이 없네, $1……?
$^全ての男がそうだって訳じゃないけど、(.+?)みたいにツンツンした女の子を組み敷きたいっていうのは、分かる願望かな。$	모든 남자가 그런 건 아니지만, $1처럼 츤츤거리는 여자를 유린하고 싶다는 것은 이해할 수 있는 욕망이라고 할까.
$^それは(.+?)の態度次第かな。$	그건 $1가 하기 나름이라고 할까.
$^俺は(.+?)に耳打ちする。すると\1は耳まで真っ赤になった。$	나는 $1에 귀띔했다. 그러자 $1는 귀까지 새빨갛게 되었다.
$^はは、可愛かったよ、(.+?)……$	하하, 귀여웠어, $1……
$^……(.+?)は、本当にエッチだな……$	……$1는 정말로 야하네……
$^羞恥に染まった(.+?)の表情を見ながら、俺は面接を終えるのだった。$	수치에 물든 $1의 표정을 보면서, 나는 면접을 끝내는 것이었다.
$^(.+?)は少し、表情を変え、頬を染めながらもそう答えてくれる。$	$1는 살짝 표정을 바꾸고 뺨을 물들이면서도 그렇게 대답해 준다.
$^クールな(.+?)を見て俺は感心し、面接は終わったのだった。$	쿨한 $1를 보고 나는 감탄했고, 면접은 끝난 것이었다.
$^……じゃあ、(.+?)と仲良くなれば、見られて興奮するようになっちゃうとか？$	……그럼 $1와 친해지면, 보여지면서 흥분하게 되는 거야?
$^(.+?)は可愛いし、綺麗だよ。$	$1는 귀엽고 이쁘지.
$^そうかな？　でも(.+?)ってエムっぽいような気がするけど……$	그런가? 그래도 $1는 M 같은 느낌이 드는데……
$^ごめんごめん、怒らないで、(.+?)。$	미안, 미안. 화내지 말아 줘 $1.
$^……場合によっては、俺のおちんちんを(.+?)のおまんこで奉仕してもらう事もあるけど？$	……경우에 따라서는 내 자지를 $1의 보지로 봉사하는 경우도 있을텐데?
$^俺の大きいから、(.+?)のおまんこに入るかな？$	내 물건이 큰데 $1의 보지에 들어가려나?
$^嬉しいな、そんな視線を集める(.+?)の身体を、俺だけが好きに出来るだなんて。$	기쁘네. 그렇게 시선을 모으는 $1의 몸을 나 혼자서만 즐길 수 있게 되다니.
$^俺は(.+?)にそっと耳打ちをする。$	나는 $1에게 살짝 귀속말을 한다.
$^(.+?)は俺の言葉にさらに身体を熱くした。$	$1는 나의 말에 몸이 더욱 뜨거워졌다.
$^ふふ、流石に俺も満足したかな、可愛かったよ、(.+?)。$	후후, 역시 나도 만족했으려나… 귀여웠어 $1.
$^はは、善処するよ。(.+?)の趣味を聞けてよかったよ。$	하하, 선처할게. $1의 취미를 들어서 좋았어.
$^耳まで真っ赤になってるよ、(.+?)。$	귀까지 새빨갛게 되었어 $1.
$^(.+?)ってマゾみたいだね。$	$1는 마조 같네.
$^息が荒いよ、(.+?)。$	숨이 거칠어 $1.
$^……俺は早く(.+?)とエッチしたくなっちゃったな。どれだけエッチなのか気になっちゃったよ。$	……난 빨리 $1와 섹스를 하고 싶어졌어. 얼마나 야한 건지 신경 쓰이네.
$^俺も(.+?)が何も言えなくなるぐらい、たくさんしてあげるよ。$	나도 $1가 아무 말도 못 할 만큼 많이 해줄게.
$^緊張の色が隠せない(.+?)。$	긴장한 기색을 감출 수 없는 $1.
$^いや、思わず目を奪われたよ、(.+?)に魅了されちゃいそうだ。$	아니, 나도 모르게 시선을 빼앗겼어, $1에게 홀린 거 같아.
$^そっか、楽しみだな。(.+?)の唇、柔らかそうだから。$	그래, 기다려지네. $1의 입술 부드러울 것 같으니까.
$^……ねぇ、(.+?)ってどんなセックスするの？$	……저기, $1는 어떤 섹스를 하는 거야?
$^……すっごくエッチだよ、(.+?)。$	…… 엄청 야하네, $1.
$^変わってるね、(.+?)は……$	특이하네, $1는……
$^緊張した(.+?)を見ながら、俺は面接を終えるのだった。$	긴장한 $1를 보면서 나는 면접을 끝내는 것이었다.
$^(.+?)が着たいものとかは、俺が絶対用意する。サイズとか着心地とか、最高のものを用意するよ、それがご主人様の役目だからね。$	$1가 입고 싶은 건 내가 꼭 준비할게. 사이즈라든가 착용감이 최고인 걸로 준비할께. 그게 주인님의 역할이니까 말야.
$^ひょっとしたらお客様にされちゃう事もあるかもしれないけど……(.+?)のファーストキスの相手は、多分俺になるかな。$	어쩌면 손님과 하게 될 지도 모르지만…… $1의 퍼스트 키스 상대는 아마도 내가 되려나.
$^ほら、ご主人様の事を楽しませてよ。ご主人様は(.+?)のエッチな言葉が聞きたいなぁ。$	이봐, 주인님을 즐겁게 해 줘. 주인님은 $1의 야한 말이 듣고 싶네.
$^ふぅん、股が緩いのかもね、(.+?)は。$	흐음, 다리를 쉽게 벌릴 것 같아, $1는.
$^(.+?)ってマゾなの？$	$1는 마조인 거야?
$^……変わってるね。ふふ、エッチな格好している(.+?)にはお似合いかも知れないけど。$	……특이하네. 후후, 야한 모습을 하고 있는 $1에게는 어울릴지도 모르지만.
$^えへへって……格好と一緒で(.+?)ってエッチだよね。$	에헤헤……하고 있는 모습 처럼 $1는 야하네.
$^途中で記憶がなくなるまで、お尻でセックスしたんだね、(.+?)は……$	도중에 기억이 없어질 때까지 엉덩이로 섹스 했구나, $1는……
$^俺は(.+?)に耳打ちする。すると\1は恥ずかしそうに身を捩る。$	나는 $1에게 귓속말을 한다. 그러자 $1는 부끄러운 듯이 몸을 비비 꼰다.
$^お初にお目にかかります、ご主人様。本日よりお世話になります、(.+?)です。$	처음 뵙겠습니다, 주인님. 오늘부터 신세를 지게 되었습니다, $1입니다.
$^(.+?)は少しだけ恥ずかしそうにしながら、丁寧に頷いた。$	$1는 약간 부끄러운 듯 하면서, 정중하게 수긍했다.
$^あ、尺八ってフェラチオの事じゃないよ？　(.+?)ってばいやらしいなぁ。$	아, 퉁소는 펠라치오를 말하는게 아닌데? $1는 정말 야하네.
$^(.+?)はどうかな？　俺の隣はいつでも空いてるよ。$	$1는 어떨까?　내 옆은 언제라도 비어 있어.
$^……えっと、ひょっとして、もし(.+?)と付き合うとしたら、アダルトビデオとかエロ本とかは……$	……음, 혹시, 만약 $1와 사귀게 된다면 성인 비디오라든지 에로 책 같은 것들은……
$^俺は、(.+?)の初めてを貰えると思うと嬉しいけどね。$	나는, $1의 처음을 받을 수 있다고 생각하면 기쁘지만.
$^ちょ、ちょっと落ち着いて(.+?)。世の中にはそうじゃない人もいるからさ……$	자, 잠깐, 침착해, $1. 세상에는 그렇지 않은 사람도 있으니까 말야……
$^……いやらしくて素敵だよ、(.+?)。$	……음란해서 멋져, $1.
$^いや……エッチで素敵だよ、(.+?)。$	아니……음란하고 멋져, $1.
$^相変わらず丁寧な(.+?)を見ながら、面接を終わりにした。$	여전히 정중한 $1를 보면서 면접을 끝냈다.
$^(.+?)は物分かりがいいね？　でも、ちょっとぐらい嫌がってもいいんだよ？$	$1는 이해력이 좋네?　그래도 조금 정도는 싫어해도 괜찮다구?
$^それで、俺もおちんちんが大きくなるから……そこから先は(.+?)に考えてもらおうかな？$	그래서 나도 자지가 커져 버리니까……거기서부터는 $1에게 맡길게?
$^(.+?)に任せるよ。$	$1에 맡겨 줘.
$^……(.+?)、面接だけど、そういうアピールはいらないかな……？$	…… $1, 면접인데 그런 어필은 필요없지 않을까……?
$^(.+?)は一生懸命なのかもね、エッチな事にも。$	$1는 열심히 하네. 야한 일에도.
$^ふぅん……まぁ、俺は(.+?)のそのえっちなおっぱいに夢中になりそうだけどね。$	흐음……뭐, 나는 $1의 그 야한 가슴에 푹 빠질 거 같은데.
$^(.+?)って真面目そうだし、そういうのは段階的にしたほうがいいかなって。$	$1는 성실해 보여서, 그런 건 단계적으로 하는 편이 좋지 않을까 해서.
$^……なんか、ちょっと(.+?)の事が分かった気がするな。$	……뭔가, $1에 대해서 조금 알 수 있었던 것 같아.
$^ああ、気にしないでいいよ、(.+?)。$	아아, 신경쓰지 않아도 돼, $1.
$^……たくさんしたことあるの？　なんだかんだ言って、そんなエッチな格好をしちゃう(.+?)だもんね。$	……많이 한 적 있는 거야? 이러니 저러니해도, 그런 음란한 모습을 해버리는 $1구나.
$^(.+?)との夜伽が楽しみだな……$	$1와의 밤시중이 기다려진다……
$^まぁ、(.+?)っぽいといえばそうなのかもね……でも、可愛くてエッチでいいと思うよ。$	뭐, $1 같다고 하면 그럴지도……그래도, 귀엽고 야해서 좋다고 생각해.
$^……それなりかぁ、(.+?)ってエッチなんじゃないかな？$	……그런 대로인가, $1가 음란한 것이 아닐까?
$^(.+?)はけつまんこでのセックスにハマって、普通のセックスじゃ満足できなくなったって事だね。$	$1는 엉덩이 보지로 하는 섹스에 빠져서 보통의 섹스로는 만족할 수 없게 됐다는 거네.
$^ごくっ……すごいね、(.+?)は……$	매우 ……대단하네, $1는……
$^ふふっ……可愛いよ、(.+?)。$	후후……사랑스러워, $1.
$^ああ、すっごく興奮した……ありがとう、(.+?)。$	아아, 굉장히 흥분했다……고마워, $1.
$^えっと……初めまして、ご主人様。本日よりお世話になります……(.+?)です。$	그니까……처음 뵙겠습니다, 주인님. 오늘부터 신세를 지는…… $1입니다.
$^そんな事ないよっ！　その包容力、普通のメイドにはないものを(.+?)は持ってる！$	그런 일 없어! 그 포용력, 보통 메이드에게는 없는 것을 $1는 가지고 있다고!
$^(.+?)のおっぱい、大好きだよ。$	$1의 가슴, 정말 좋아해.
$^まぁ、(.+?)の初めては俺が貰うけどね。$	아무튼 , $1의 처음은 내가 받는 것이야.
$^ニコニコと朗らかな(.+?)を見ながら、面接を終わりにした。$	싱글벙글 명랑한 $1를 보면서, 면접을 끝냈다.
$^ふふ、ナイスツッコミだね、(.+?)。$	후후, 나이스 츳코미다, $1.
$^(.+?)はけつまんこでのセックスにハマって、普通のセックスに興味なくなっちゃったんだ。$	$1은 엉덩이 보지에서의 섹스에 빠져, 보통 섹스에 흥미없게 되어버렸어.
$^(.+?)、ちょっと聞いてくれない？$	$1, 잠깐 들어주지 않을래?
$^ふうん、じゃあ(.+?)が思いつかないようなエッチな場所にタトゥーを入れたり……。$	흠, 그럼 $1가 생각하지 못한 것 같은 야한 곳에 문신을 하거나…….
$^でも、(.+?)だってオシャレだって……。$	그래도, $1도 멋진데…….
$^そっか……せっかく(.+?)は俺の物だって分かるようなタトゥーにしようと思ったんだけどな……。$	그래…… 모처럼 $1는 내꺼라고 알 수 있게 할만한 문신을 하려고 했는데…….
$^それにしても……すごく似合っているよね、(.+?)……。あ、そうだ！$	그나저나…… 되게 잘 어울리네, $1……. 아, 맞다!
$^ははは、いいじゃないか……あ、(.+?)、手、気をつけてっ！$	하하하, 괜찮지 않을까…… 아, $1, 손, 조심해!
$^悔しそうな表情を浮かべた後、勤めて平静を装いつつ、(.+?)は本の音読を始める……。$	분한 듯한 표정을 했지만, 그 뒤 아무렇지 않은 척 하면서 $1는 책을 소리내어 읽기 시작한다…….
$^ねぇ、(.+?)。$	저기, $1.
$^俺の言葉に、動揺したのか(.+?)の手元が狂う。$	내 말에 동요했는지 $1의 손놀림이 흐트러진다.
$^今みたいな格好の(.+?)に、色々な花を飾り付けてさ……、うん、すごく見ごたえありそう。$	지금 같은 모습의 $1에, 다양한 꽃을 장식해 말야……, 응, 굉장히 보고 서로 참을 것 같다.
$^それはそうかも。ということで、(.+?)に花を飾ってみたいなぁ……。$	그것은 그럴지도. 라는 것으로, $1에 꽃을 장식해 보고 싶은…….
$^だって、(.+?)は可愛いし綺麗だろ、花も可愛いし綺麗だから、それが合わされば……。$	왜냐하면, $1는 사랑스럽고 예쁠 것이다, 꽃도 사랑스럽고 예쁘기 때문에, 그것이 합쳐지면…….
$^エッチの時ってさ、シャワー浴びるよね。(.+?)は化粧を落とす？　落とさない？　どっち派？$	엣치때란 말야, 샤워 받네요. $1는 화장을 떨어뜨려? 떨어뜨리지 않아? 어느 쪽파?
$^いや、(.+?)の事を知りたくて。で、どうなの？$	아니, $1의 일을 알고 싶어서. 그래서, 어때?
$^(.+?)の肌をエステ担当の女性が触っている。$	$1의 피부를 에스테틱 담당의 여성이 손대고 있다.
$^しかし、そのせいでせっかくの(.+?)のあられもない格好を鑑賞できない……。$	그러나, 그 탓으로 모처럼의$1의 단정치 못한 모습을 감상 할 수 없다…….
$^(.+?)を気持ちよくさせればいいんだろう？　それなら――。$	$1를 기분 좋게 시키면 좋을 것이다? 그렇다면―.
$^だって(.+?)、いつも俺の手を喜んでくれてるじゃないか。$	왜냐하면$1, 언제나 나의 수를 기뻐해 주고 있지 않은가.
$^この前だって、(.+?)は夜伽の時、とっても可愛かった――$	일전에도, $1는 밤시중때, 매우 사랑스러웠다―
$^ははは、冗談だよ。うん、(.+?)をからかったら、少し退屈が紛れたかな。$	하하하, 농담이야. 응, $1를 조롱하면, 조금 지루함이 잊혀졌을까나.
$^きわどい格好のまま、洗濯物を畳む(.+?)。$	아슬아슬한 모습인 채, 세탁물을 접는 $1.
$^手が止まってるよ、(.+?)。早く終わらせた方がいいんじゃない？$	손이 멈추고 있다, $1. 빨리 끝내는 것이 좋은 것이 아니야?
$^(.+?)をからかうのは、本当に楽しいなぁ。$	$1를 놀리는건, 정말로 즐거운데.
$^俺の目の前では、エッチな衣装を身に付けた(.+?)が、模様替えのお仕事をしている。$	나의 눈앞에서는, 엣치한 의상을 몸에 걸친 $1이, 재배치의 일을 하고 있다.
$^彼女が動く度、(.+?)の恥ずかしい部分がちらちらと見えて俺の目を楽しませていた。$	그녀가 움직일 때, $1의 부끄러운 부분이 힐끔힐끔 보여 나의 눈을 즐겁게 하고 있었다.
$^他のお客様に見られちゃうねぇ……それを恥らう(.+?)も見てみたいな……どうしようかなぁ？$	다른 고객에게 보여져 버리네요…… 그것을 부끄러워하는 $1도 보고 싶다…… 어떻게 할까나?
$^あれ？　(.+?)、何してるの？$	어? $1, 뭐 하고 있는 거야?
$^大丈夫。(.+?)なら、きっとすぐ出来るようになるよ。$	괜찮아. $1라면, 반드시 금방 할 수 있게 된다.
$^ふーん……でも、裁縫する(.+?)も可愛いと思うよ。$	흐응…… 에서도, 재봉 하는 $1도 사랑스럽다고 생각한다.
$^(.+?)、調子はどう？$	$1, 상태는 어때?
$^楽しみだな、(.+?)の刺繍。$	기다려진다, $1의 자수.
$^(.+?)、裁縫してるの？$	$1, 재봉 하고 있는 거야?
$^ねぇ、(.+?)。指、ちょっと赤くなってない？$	저기, $1. 손가락, 조금 붉어졌지 않아?
$^(.+?)に痕が残ったりしたら俺が嫌だから。これは命令。$	$1에 자국이 남거나 하면 내가 싫기 때문에. 이것은 명령.
$^うん、(.+?)の気持ちは嬉しかったよ。$	응, $1의 기분은 기뻤어요.
$^でも俺には裁縫より(.+?)のほうが大事だから。$	그렇지만 나에게는 재봉보다 $1쪽이 큰 일이니까.
$^(.+?)はどう？　裁縫楽しい？$	$1는 어때? 재봉 즐거워?
$^そういえばあのエプロン……(.+?)が作ったの？$	그렇게 말하면 그 에이프런…… $1가 만들었어?
$^たしかに、どうせなら俺も(.+?)の手縫いのが嬉しいかな。$	분명히, 어차피라면 나도 $1의 손바느질의 것이 기쁠까.
$^あれ、どうしたの？　(.+?)。$	저것, 무슨 일이야? $1.
$^きっと(.+?)なら可愛いのが作れるよ。$	반드시 $1라면 사랑스러운 것이 만들 수 있다.
$^はは、大丈夫。(.+?)が作ってくれるものなら、何でも嬉しいよ。$	는은, 괜찮아. $1가 만들어 주는 것이라면, 뭐든지 기뻐.
$^やぁ、(.+?)。裁縫してるの？$	여, $1. 바느질 하는거야?
$^花より(.+?)のほうが綺麗だからね。$	꽃보다 $1쪽이 예쁘니까.
$^うんうん。特に、(.+?)は指まで綺麗だからね。$	응응. 특히, $1는 손가락까지 예쁘니까.
$^そこも(.+?)にお任せするよ。$	거기도 $1에 맡긴다.
$^あれ？　(.+?)、料理してるの？$	어? $1, 요리하고 있는 거야?
$^せっかくだから、料理してる(.+?)を見学させてよ。$	모처럼이니까, 요리하고 있는 $1을 견학시켜요.
$^いいよ、全然。(.+?)は料理得意なの？$	좋아, 전혀. $1는 요리 자신있어?
$^悪くなんてないよ。偉いんだね、(.+?)は。$	나쁘고 같은거 없어. 훌륭하네,$1는.
$^でもそれが嫌だから、(.+?)は練習してるんでしょ？$	그렇지만 그것이 싫기 때문에,$1는 연습하고 있는거죠?
$^そんなことないと思うけどなぁ。(.+?)が作ったものだからかな？$	그렇지 않다고 생각하지만. $1가 만든 것이니까일까?
$^(.+?)、今日のご飯は何かな？$	$1, 오늘의 밥은 무엇이지?
$^いや、(.+?)がどんなものを作るのか、興味があってさ。$	아니, $1가 어떤 것을 만드는지, 흥미가 있어 말야.
$^(.+?)、最近料理が上手くなって来たんじゃない？$	$1, 최근 요리가 능숙해져 왔지 않아?
$^よくわからないけど、(.+?)が必要なら全然構わないよ。$	잘 모르지만, $1가 필요하면 전혀 상관없어.
$^うーん、(.+?)が作ってくれたものならなんでも、かな。$	응,$1가 만들어 준 것이라면 뭐든지, 일까.
$^(.+?)は料理、得意じゃないの？$	$1는 요리, 자신없는거야?
$^(.+?)、料理してたんだ。$	$1, 요리하고 있었던 것이다.
$^ねぇ、(.+?)って和食と洋食のどっちが好き？$	응, $1는 일식과 양식의 어느 쪽을 좋아해?
$^最近、(.+?)の料理は何を食べても美味しいから、楽しみだな。$	최근, $1의 요리는 무엇을 먹어도 맛있기 때문에, 기다려진다.
$^あれ、(.+?)。料理してるの？$	어라, $1. 요리하고 있는 거야?
$^それに(.+?)の料理なら、いっぱい、色んなものを食べたいしね。$	게다가 $1의 요리라면, 가득, 여러 가지 것을 먹고 싶기도 하고.
$^(.+?)が気になってさ。ちょっと見学してもいいかな？$	$1가 신경이 쓰여 말야. 조금 견학해도 될까?
$^いいんだよ。(.+?)を眺めてるだけで、楽しいから。$	좋아. $1를 바라보고 있는 것만으로, 즐거우니까.
$^ごめんごめん。でもこれ美味しいよ、(.+?)。$	미안 미안. 그렇지만 이것 맛있어, $1.
$^はは、大げさだな(.+?)は。$	하하, 과장이 심하구나 $1는.
$^本当に(.+?)は気がきいて……可愛いなぁ。$	정말로 $1는 기분이 (들)물어…… 사랑스럽구나.
$^(.+?)、何を読んでるの？$	$1, 뭐 읽고 있어?
$^誓って言うよ、今のは本当に偶然……でもそんな本を読んでるなんて、(.+?)は勉強熱心だね。$	결코 말한다, 지금 것은 정말로 우연…… 그렇지만 그런 책을 읽고 있는, $1는 공부 열심이다.
$^……もう本に集中してる。(.+?)の邪魔しないように、静かに移動しよう。$	…… 이제(벌써) 책에 집중하고 있다. $1의 방해 하지 않도록, 조용하게 이동하자.
$^あれ、(.+?)？　こんなところで何をしてるんだ。$	어라, $1? 이런 곳에서 무엇을 하고 있다.
$^へえ。偉いね、(.+?)は。$	에. 훌륭하다, $1는.
$^あっち行ってって言われても……あれ？　(.+?)、その本って……$	저쪽 가라고 말해져도…… 어? $1, 그 책은……
$^それって、夜伽の為の本だよね？　(.+?)、どうしてそんなものを読んでいたの？$	그 거, 밤시중을 위한 책이지요? $1, 어째서 그런 것을 읽고 있었어?
$^いや、さすがにそこまでは言ってないけど……でも、夜伽に対して(.+?)がそこまで熱心だなんて、なんだか嬉しいなぁ。$	아니, 과연 거기까지는 말하지 않지만…… 그렇지만, 밤시중에 대해서$1가 거기까지 열심이다 라고, 왠지 기쁜데.
$^ああ、わかったよ。ごめんね、(.+?)。そのまま勉強続けてね。$	아, 알았어. 미안해요, $1. 그대로 공부 계속해.
$^あれ、どうしたの、(.+?)。なんだか難しい顔してるけど。$	저것, 무슨 일이야, $1. 왠지 어려운 얼굴 하고 있지만.
$^そりゃ当然だよ、(.+?)は俺のメイドなんだから、気に掛けるのは当然じゃないか。$	그렇다면 당연해, $1는 나의 메이드인 것이니까, 걱정하는 것은 당연하지 않은가.
$^なんだか不本意な笑われ方をしたけど……。(.+?)が笑ってくれて嬉しいよ。$	어쩐지 본의가 아닌 웃어지고 (분)편을 했지만……. $1가 웃어 주어 기뻐.
$^うん、わかった。それじゃ、ほどほどにね、(.+?)。$	응, 알았다. 그러면, 적당히, $1.
$^やあ、(.+?)。なに読んでるの？$	여, $1. 뭐 읽고 있는 거야?
$^わ、わかったけど……。(.+?)、もしかして照れてるの？$	원, 알았지만……. $1, 혹시 수줍어하고 있는 거야?
$^(.+?)、熱心に読んでるけど、それ何の本？$	$1, 열심히 읽고 있지만, 그것 무슨책?
$^あれ、それって夜伽の本だよね。へえ……(.+?)、この本を一生懸命読んでたんだ？$	저것, 그 거 밤시중의 책이지요. 헤에……$1, 이 책을 열심히 읽고 있었던 것이야?
$^え？　俺は別に(.+?)がエッチなんて、そんなこと一言も言ってないけど。$	네? 나는 별로 $1가 엣치이라니, 그런 일한마디도 말하지 않지만.
$^うん、ありがとう。夜伽楽しみにしてるね、(.+?)。$	응, 고마워요. 밤시중 기대하고 있네요, $1.
$^……ん？　あれ、(.+?)だ。そんなところで寝てたら風邪引くよ。$	…… 응? 저것, $1다. 그런 곳에서 자고 있으면 감기 걸린다.
$^夢じゃないよ、(.+?)。ほら、起きて。$	꿈이 아니야, $1. 이봐요, 일어나.
$^まあ、その……うん。(.+?)の寝顔、見ちゃったけど。$	뭐, 그…… 응. $1의 잠자는 얼굴, 봐 버렸지만.
$^でも(.+?)の寝顔、すごく可愛かったよ。$	그렇지만$1의 잠자는 얼굴, 굉장히 사랑스러웠어요.
$^そうか。それじゃあ俺も行くね、(.+?)。$	그런가. 그러면 나도 가네요, $1.
$^あれ、(.+?)、奇遇だね。こんなところで何を読んでるの？$	저것, $1, 우연이구나. 이런 곳에서 무엇을 읽고 있는 거야?
$^嫌いなんかじゃないよ。すごく嬉しい、(.+?)が俺の為に頑張ってくれて。$	싫은 따위가 아니야. 굉장히 기쁜, $1가 나를 위해서(때문에) 노력해 줘.
$^じゃあ(.+?)の奉仕、楽しみにしてるね。$	자 $1의 봉사, 기대하고 있네요.
$^わかったよ、(.+?)。楽しみは後に取っておく事にするよ。$	알았어, $1. 즐거움은 뒤로 취해 두는 일로 한다.
$^え、この花、(.+?)が活けたの？$	네, 이 꽃,$1가 활자리수의?
$^そうだね。少し不器用だけど、凄く綺麗だ。すごいね、(.+?)。$	그렇다. 조금 서투르지만, 굉장히 예쁘다. 굉장하다,$1.
$^なに、(.+?)？$	뭐야, $1?
$^でも、(.+?)の活けた花、綺麗だけどね。$	그렇지만, $1의 꽃꽂이, 예쁘지만 말야.
$^へえ！　確かに(.+?)の言う通り、とても綺麗に活けられてるね。$	에! 확실히 $1가 말하는 대로, 매우 예쁘게 활 차지고 있네요.
$^見事だなぁ。(.+?)が俺のメイドで嬉しいよ。$	훌륭하다. $1가 나의 메이드로 기뻐.
$^どう、(.+?)。今日の調子は？$	어때, $1. 오늘의 상태는?
$^うん、確かに見事だ。さすが、(.+?)だね。$	응, 확실히 훌륭하다. 과연, $1구나.
$^どうしたの、(.+?)。何か気に障ったかな？$	무슨 일이야,$1. 뭔가 비위에 거슬렸을까나?
$^え？　急にどうしたんだ、(.+?)。$	에? 갑자기 어쩐일이야, $1.
$^いや、すごいよ。見事だ。(.+?)、華道の先生になれるんじゃないか？$	아니, 굉장해. 훌륭하다. $1, 화도의 선생님이 될 수 있는 것이 아닌가?
$^そう？　……うん、でも(.+?)と同じぐらい綺麗だよ。これは思わず見入っちゃうな。$	그래? …… 응, 그렇지만$1과 같은 정도 예뻐. 이것은 무심코 주시해 버리는군.
$^そう？　綺麗な物に綺麗って言っただけだよ、(.+?)。普通の事だろ。$	그래? 예쁜 것에 예쁘다고 말한 것 뿐이야, $1. 보통 일일 것이다.
$^え？　急にどうしたの、(.+?)。$	네? 갑자기 무슨 일이야, $1.
$^ん？　よくわからないな。(.+?)は、自分の活け花の出来栄えに満足してないの？$	응? 잘 모르는구나. $1는, 자신의 활꽃의 솜씨에 만족하지 않는거야?
$^え、そんな事ないよ。(.+?)の活け花は確かに綺麗だけど、\1には敵わないよ。$	네, 그런 일 없어. $1의 활꽃은 확실히 예쁘지만, $1에는 이길 수 없어.
$^勿論だよ。……なんだ、(.+?)、そんな事を心配していたのか。$	물론이야. …… 무엇이다, $1, 그런 일을 걱정하고 있었는가.
$^ごめんごめん、そんなつもりじゃなかったんだ。でも、その心配は杞憂だよ。俺は(.+?)の事を一番見てるから。$	미안 미안, 그런 생각이 아니었던 것이다. 그렇지만, 그 걱정은 기우야. 나는$1의 일을 제일 보고 있기 때문에.
$^わあ、今日も見事だね、(.+?)の活けた花は。$	우와 오늘도 훌륭하다, $1의 꽃꽂이은.
$^でも、(.+?)の活け花を見ていなかったら、気付かなかった事かもしれないな。$	그렇지만, $1의 활꽃을 보지 않았으면, 깨닫지 않았던 것일지도 모르는구나.
$^これは、目を奪われるね……凄く綺麗だよ、(.+?)。それに、どこか可愛らしい感じもするし。$	이것은, 정신을 빼앗기네요…… 굉장히 예뻐, $1. 게다가, 어딘가 사랑스러운 느끼기도 하고.
$^ああ、勿論。花のように綺麗だし可愛いよ、(.+?)。$	아, 물론. 꽃과 같이 예쁘고 사랑스러워, $1.
$^いや、そうじゃなくて。(.+?)が一番だよ。\1が一番綺麗だ。$	아니, 그렇지 않아서. $1가 제일이야. $1가 제일 깨끗하다.
$^(.+?)が化粧してるのを見るの、なんだか楽しいけどね。$	$1가 화장하고 있는 것을 보는 것, 왠지 즐겁지만 말야.
$^え、本当？　俺はそうは思わないけど……(.+?)、お化粧上手だと思うよ。$	네, 사실? 나는 그렇게는 생각하지 않지만……$1, 화장 능숙하다고 생각한다.
$^可愛いね、(.+?)は。$	사랑스럽다, $1는.
$^ねぇ、(.+?)はメイクにどれぐらい時間をかけるの？$	응, $1는 메이크에 어느 정도 시간을 들이는 거야?
$^そうだよね、すっぴんでも(.+?)は可愛いと思うな。$	그렇네요, 맨얼굴에서도$1는 사랑스럽다고 생각하는구나.
$^……あれ？　(.+?)、なんだかいつもと違うね。$	…… 어? $1, 뭔가 평상시와 다른 것.
$^ちゃんとって言われてもな……。化粧しなくても(.+?)は綺麗だし。$	짱와라고 말해져도……. 화장하지 않아도$1는 예쁘고.
$^ねえ、(.+?)。$	저기, $1.
$^(.+?)は、どこか行きたいところはないの？$	$1는, 어딘가 가고 싶은 곳은 없는거야?
$^そうだね。じゃあプールに行けば、(.+?)の水着姿が見られるってわけか。$	그렇네. 그러면 풀에 가면,$1의 수영복 모습을 볼 수 있다는 것인가.
$^上手にできたね、(.+?)。$	제대로 했군요, $1.
$^え、それを俺の口から説明していいの？　今まさに口紅をしてる(.+?)の前で？$	네, 그것을 나의 입으로부터 설명해도 좋은거야? 지금 확실히 루즈를 하고 있는$1의 앞에서?
$^いや、でも(.+?)がどうしても聞きたいっていうなら話すよ。$	아니, 그렇지만$1이 아무래도 (듣)묻고 싶다고 말한다면 이야기한다.
$^(.+?)って、いつも綺麗にしてるよね。$	$1는, 언제나 예쁘게 하고 있네요.
$^そうだね。でも(.+?)はもう充分だと思うけどなぁ。$	그렇다. 그렇지만 $1은 이제(벌써) 충분하다고 생각하지만.
$^すごいね、(.+?)の向上心は俺も見習って、立派なご主人様にならないといけないな。$	굉장하다, $1의 향상심은 나도 본받아, 훌륭한 주인님이 되지 않으면 안 되는구나.
$^本当に？　ありがとう、そんな風に言ってくれるなんて。(.+?)はメイドの鑑だな。$	정말로? 고마워요, 그런 식으로 말해 주다니. $1는 메이드의 귀감이다.
$^おお、本当だ。(.+?)、本当に綺麗だよ。$	사실이다. $1, 정말로 예뻐.
$^気合が入ってるね、(.+?)。$	기합이 들어가있네요, $1.
$^化粧してる途中でも、(.+?)は充分綺麗だけどね。$	화장하고 있는 도중에도, $1는 충분히 깨끗하지만 말야.
$^なに？　あ、(.+?)もしかして……俺に構ってほしいの？$	뭐? 아, $1혹시…… 내가 상관하기를 원하는거야?
$^嬉しいな、(.+?)。そんなに想ってくれるなんて。$	기쁘다, $1. 그렇게 생각해 주다니.
$^毎日はどうかな……。(.+?)はメイドなんだし、仕事はしてもらわないと困るな。$	매일은 어떨까……. $1는 메이드인거고, 일은 해 받지 않으면 곤란하구나.
$^そうだなぁ……。それは、(.+?)の頑張り次第かな？$	그렇다……. 그것은, $1가 노력하는 대로일까?
$^やあ、(.+?)。すっかりご機嫌だね。$	야, $1. 완전히 기분이구나.
$^(.+?)は、女の人に触れるのってどう思う？$	$1는, 여자에게 접하는 것은 어떻게 생각해?
$^え？　素的な事……？　えーっと、そうだな、(.+?)を気持ち良くする方法か……$	네? 멋진 일……? 엣또, 그렇다, $1를 기분 좋게 하는 방법인가……
$^(.+?)の為になって、俺の為にもなる。まさに一石二鳥だね。$	$1에게 도움이 되어, 나를 위해서(때문에)도 된다. 확실히 일석이조구나.
$^まあね。それに、(.+?)が喜んでくれるなら良い気分だよ。$	그냥. 게다가, $1가 기뻐해 준다면 좋은 기분이야.
$^でも、本当に気持ち良さそうだね、(.+?)。$	그렇지만, 정말로 기분 좋은 것 같다, $1.
$^種類が違う？　それってどういうこと？　具体的に教えてくれないかな、(.+?)。$	종류가 달라? 그거라는건 어떻게 말하는 일? 구체적으로 가르쳐 주지 않을까, $1.
$^別に構わないでしょ。それとも(.+?)は、俺とするのが嫌なのか？$	별로 상관없지요. 그렇지 않으면 $1은, 나로 하는 것이 싫은 것인가?
$^はは、(.+?)は可愛いな。そんな恰好で照れてるなんて。$	는은, $1는 사랑스러운데. 그런 모습으로 수줍고 있다니.
$^(.+?)の色んな顔が見たくて、思わずね。悪気があるわけじゃないんだよ。$	$1의 여러 가지 얼굴을 보고 싶어서, 무심코. 악의가 있는 것이 아니어.
$^あれ、(.+?)、なんだか余裕だね。$	저것, $1, 뭔가 여유구나.
$^そうかそうか、(.+?)も成長してるって事だね。$	그런가 그런가, $1도 성장하고 있다는 일이구나.
$^ん、なんだい、(.+?)。$	응, 어떤거야, $1.
$^……そうか。嬉しいよ、(.+?)。でも俺は今の\1が好きだから、そのままでいいよ。$	…… 그런가. 기뻐, $1. 그렇지만 나는 지금의 $1를 좋아하기 때문에, 그대로 좋아.
$^あれ、(.+?)。掃除みたいだね。どうだい、仕事の方は。慣れないうちは、やっぱり大変？$	저것, $1. 청소같다. 어때, 일은. 익숙해지지 않는 동안은, 역시 큰 일?
$^え？　別に、俺は(.+?)が弱音を吐いただなんて、そんなの一言も言ってないけど。$	네? 별로, 나는$1이 약한소리를 했다니, 그런 것 한마디도 말하지 않지만.
$^でも、(.+?)の掃除を手伝う事くらいならできるかもしれない。$	그렇지만, $1의 청소를 돕는 일 정도라면 가능할지도 모른다.
$^やあ、(.+?)。調子はどうだい？$	야, $1. 상태는 어때?
$^暇……ではないけどさ。(.+?)がどうしてるのかなって、気になって。$	짬…… 은 아니지만 말야. $1가 어떻게 하고 있는 것일까 하고, 신경이 쓰여.
$^なんだかご機嫌斜めだね、(.+?)。どうしたの？$	어쩐지 심기 불편함이구나, $1. 무슨 일이야?
$^おお、(.+?)恰好良いな。$	$1근사한데.
$^わかった、ありがとう。(.+?)の言う通りにするよ。$	알았다, 고마워요. $1가 말하는 대로 한다.
$^今日も精が出るね、(.+?)。$	오늘도 힘쓰네요, $1.
$^いや、たまたま通り掛かってね。すると偶然、(.+?)がいたってわけ。$	아니, 우연히 마침 지나가. 그러자 우연, $1가 있었다는 것.
$^……どうやら、(.+?)にはまだ早かったようだな。$	…… 아무래도, $1에는 아직 빨랐던 것 같다.
$^まあね……。この件については、また機会があった時にでも話そう。それじゃあね、(.+?)。$	그냥……. 이 건에 대해서는, 또 기회가 있었을 때라도 이야기하자. 그것이 아니다, $1.
$^いや、(.+?)の様子はどうかと思ってね。$	아니, $1의 모습은 어떨까라고 생각해.
$^さすが(.+?)、仕事熱心だね。$	과연 $1, 일 열심이다.
$^ああ、あるね……。まあ(.+?)の言う通り、便利そうではあるんだけどね……。$	아, 있네요……. 뭐$1가 말하는 대로, 편리한 것 같은 것은 않지만…….
$^ああ、わかった。(.+?)がどうしてもお掃除ロボが欲しいっていうなら……。$	아, 알았다. $1가 아무래도 청소 로보트를 갖고 싶다고 말한다면…….
$^わ、わかったよ。……まったく、(.+?)は何をそんなに慌ててるんだ？$	원, 알았어. …… 완전히, $1는 무엇을 그렇게 당황하고 있지?
$^おや、(.+?)。頑張ってるね。$	이런, $1. 노력하고 있네요.
$^ああ、うん。それじゃ(.+?)、お掃除頑張ってね。$	아, 응. 그러면 $1, 청소 노력해.
$^お、(.+?)じゃないか。お仕事、頑張ってるみたいだね。$	$1가 아닌가. 일, 노력하고 있는 것 같다.
$^でも、(.+?)の旦那様になる人は幸運だね。こんなに素敵なメイドさんが相手なんてさ。$	그렇지만, $1의 서방님이 되는 사람은 행운이구나. 이렇게 멋진 가정부가 상대라니 말야.
$^いや、偶然(.+?)を見つけてさ。気になったから。$	아니, 우연히 $1를 찾아내 말야. 신경이 쓰였기 때문에.
$^ああ、そうなんだ。でも(.+?)に家事をしてもらえたら、さぞかし幸せだろうね。$	아, 그렇다. 그렇지만 $1에 가사를 해 줄 수 있으면, 필시 행복하겠지.
$^やぁ、(.+?)。$	여, $1.
$^(.+?)と少し話がしたくてさ。$	$1와 조금 이야기를 하고 싶어서 말야.
$^はは、(.+?)は可愛いからね。一日中でも話してたいぐらいだよ。$	는은, $1는 사랑스러우니까. 하루종일에서도 이야기해 싶을 정도야.
$^(.+?)は髪型って変えたりしないの？$	$1는 머리 모양은 바꾸거나 하지 않는거야?
$^(.+?)、何か考え事？$	$1, 뭔가 걱정거리?
$^(.+?)、模様替えの調子はどう？$	$1, 재배치의 상태는 어때?
$^はは、そうかも。でもそれ以上に(.+?)と話したくてさ。$	는은, 그럴지도. 그렇지만 그 이상으로$1라고 이야기하고 싶어서 말야.
$^ならきっと部屋の奥がいいよ。(.+?)はそうしたいんでしょ？$	라면 반드시 방의 안쪽이 좋아. $1는 그렇게 하고 싶지요?
$^(.+?)が模様替えすることに意味があるんだよ。$	$1가 재배치하는 것에 의미가 있는거야.
$^お、(.+?)。模様替えしてるの？$	$1. 재배치하고 있는 거야?
$^はは、ごめんごめん。でもこの部屋も、もちろん(.+?)のことも好きだよ。$	는은, 미안 미안. 그렇지만 이 방도, 물론 $1의 일도 좋아해.
$^(.+?)は？　俺のこと好き？$	$1는? 나의 일 좋아?
$^はは、ありがとう。(.+?)のこと、もっと好きになりそうだよ。$	는은, 고마워요. $1의 일, 좀 더 좋아하게 될 것 같아.
$^ははは。でも(.+?)の好きな植物を置けばいいからね？$	하하하. 그렇지만$1이 좋아하는 식물을 두면 좋으니까?
$^うん、ありがとう。(.+?)が俺のメイドでよかったよ。$	응, 고마워요. $1가 나의 메이드로 좋았어요.
$^それじゃお願い、(.+?)。$	그러면 부탁해요, $1.
$^どうしても、(.+?)のお酒が飲みたいなぁ。$	아무래도, $1의 술을 마시고 싶은데.
$^え、そうかな。でも(.+?)はそんな事しないでしょ？$	네, 그럴까. 그렇지만$1은 그런 일 하지 않지요?
$^そ、そうだね……。気をつけるよ、(.+?)。$	그렇네……. 조심하는, $1.
$^いやいや、それは(.+?)が酔ってるからじゃないかな。気のせいだと思うよ。$	아니아니, 그것은$1이 취하고 있기 때문이 아닐까. 기분탓이라고 생각한다.
$^そうだね、上手になってきたよ、(.+?)。$	그렇다, 능숙하게 되었어, $1.
$^ああ、まだまだ飲めるよ。(.+?)が相手なら、尚更ね。$	아, 아직도 마실 수 있다. $1가 상대라면, 더욱 더군요.
$^どうしたの、(.+?)。なんだか浮かない顔してるけど。$	무슨 일이야, $1. 뭔가 뜨지 않는 얼굴 하고 있지만.
$^(.+?)が相手してくるんだったら俺は嬉しいからさ。$	$1가 상대 해 오는 것이라면 나는 기쁘기 때문에.
$^ああ、もちろん。それに、俺が酔っ払ったら、(.+?)が面倒見てくれるんでしょ？$	아아, 물론. 게다가, 내가 몹시 취하면, $1가 돌봐 줄래?
$^はは、(.+?)と話して楽しくなり過ぎちゃったら、いっぱい飲んじゃうかもしれないな。$	하하, $1라고 이야기해 너무 즐거워져 버리면, 가득 마셔 버릴지도 모르는구나.
$^じゃあお願いするよ、(.+?)。$	그러면 부탁하는, $1.
$^頼もしいな、(.+?)。それじゃ今日は、好きに飲むよ。$	믿음직하다, $1. 그러면 오늘은, 좋아하게 마신다.
$^それじゃ俺、(.+?)の事が聞きたいな。少しくらいならいいでしょ？$	그러면 나, $1의 일을 (듣)묻고 싶은데. 조금 정도라면 좋지요?
$^(.+?)が楽しいなら、俺も嬉しいよ。$	$1가 즐거우면, 나도 기뻐.
$^でも、(.+?)は飲み過ぎないように気を付けた方がいいかもね。$	그렇지만, $1는 과음하지 않게 조심하는 것이 좋을지도.
$^(.+?)、飲み過ぎじゃない？$	$1, 과음이 아니야?
$^それならいいけどね。(.+?)、いい飲みっぷりだからさ。$	그렇다면 좋지만 말야. $1, 좋은 먹는 모습이니까.
$^俺も、(.+?)とこうやって話すの楽しいよ。$	나도, $1이럭저럭 하는 이야기하는 것 즐거워.
$^ああ、もちろんだよ。でも(.+?)、あんまり飲み過ぎないように気を付けた方がいいよ。$	아, 물론이야. 그렇지만 $1, 그다지 과음하지 않게 조심하는 것이 좋아.
$^うぅん、どうだろうね。まあ、酔っ払って色っぽい(.+?)も捨て難くはあるけど。$	응, 어떨까. 뭐, 몹시 취해 요염한 $1도 버리기 어렵지는 있지만.
$^そりゃまあね。仕事とはいえ、(.+?)が他のお客様と話してるのは、ちょっと嫌だなって思うよね。$	그렇다면 그냥. 일이라고는 해도, $1가 다른 고객과 이야기하고 있는 것은, 조금 싫다 하고 생각하네요.
$^心配はしてないよ。俺は、(.+?)の事を信頼してるから。$	걱정은 하고 있지 않아. 나는, $1의 일을 신뢰하고 있기 때문에.
$^そうだね、(.+?)。丁度、俺も同じ事考えてたよ。$	그렇다, $1. 꼭, 나도 같은 일 생각하고 있었어.
$^そりゃそうだよ。(.+?)と二人でこうしているんだからさ。$	그것은 그래. $1와 둘이서 이렇게 하고 있기 때문에.
$^本当の事言っただけだよ。(.+?)も同じ気持ちだと、嬉しいんだけどな。$	사실 말한 것 뿐이야. $1도 같은 기분이라고, 기쁘지만.
$^ああ、もちろんだよ。これからも一緒にいよう、(.+?)。$	아, 물론이야. 앞으로도 함께 있자, $1.
$^ただ(.+?)のほうが先輩なのは間違いないんだからさ、自信を持って、気軽にやってくれればいいんだよ。$	다만$1쪽이 선배인 것은 틀림없기 때문에, 자신을 가져, 부담없이 해 주면 좋아.
$^声、小さくない？　(.+?)。$	소리, 작지 않아? $1.
$^いやぁ、俺は(.+?)との夜伽が一番気持ちいいからね。$	아니, 나는$1과의 밤시중이 제일 기분이 좋으니까.
$^き、厳しいね、(.+?)。$	와, 어렵다, $1.
$^えっと、さすがにまだ(.+?)のほうが気持ちいいよ？$	어와 과연 아직 $1쪽이 기분이 좋아?
$^(.+?)、研修はどうだった？$	$1, 연수는 어땠어?
$^頑張り屋だね、(.+?)は。$	노력파구나, $1는.
$^(.+?)が針と糸をに手に持ち、布を縫い付けている。$	$1가 바늘과 실을에 손에 가져, 옷감을 꿰매고 있다.
$^(.+?)、俺の事そんなに想ってくれてるの？$	$1, 나의 일 그렇게 생각해 주고 있는 거야?
$^視線で子供かぁ……それはもったいないね。子供はちゃんと子作りして作らないと。(.+?)、子供欲しいの？$	시선으로 아이인가…… 그것은 아깝다. 아이는 분명하게 아이 만들어 해 만들지 않으면. $1, 아이 갖고 싶은거야?
$^だってその格好だと(.+?)が火傷しちゃうじゃない？$	왜냐하면 그 모습이라면 $1이 화상 입어 버리지 않아?
$^(.+?)はとっても目に楽しい、エッチな格好でキッチンに立っている。$	$1는 매우 눈에 즐거운, 엣치한 모습으로 키친에 서 있다.
$^まあまあ気にしないで。料理の内容より、(.+?)がその姿で料理をするところを見るのが目的だし。$	그저 신경쓰지 마. 요리의 내용보다, $1가 그 모습으로 요리를 하는 곳을 보는 것이 목적이고.
$^(.+?)は俺の用意した夜伽の本を目の前で読んでいる。$	$1는 나의 준비한 밤시중의 책을 눈앞에서 읽고 있다.
$^(.+?)、ちょっといいかな？$	$1, 잠깐 괜찮아?
$^あれ？　(.+?)どうしたの？$	어? $1무슨 일이야?
$^そう言わないでさ、(.+?)はどうなの？　そんな格好でエッチな本を読んでたら、濡れない？$	그렇게 말하지 말고야 말야, $1는 어때? 그런 모습으로 엣치한 책을 읽고 있으면, 젖지 않아?
$^じゃ、さっきから熱心に読んでいるそれを見て、(.+?)は何も感じないのかな？$	그러면, 조금 전부터 열심히 읽고 있는 그것을 봐, $1는 아무것도 느끼지 않는 걸까나?
$^ほら、正直に言って、(.+?)？$	이봐요, 정직하게 말해, $1?
$^見てみたいなぁ……、あのさ、(.+?)、相談なんだけど――。$	보고 싶다……, 그런데 말이야, $1, 상담이지만―.
$^エッチな生け花を、(.+?)の体を使ってやらせてほしいなぁ……って、あの、怒ってる……？$	엣치한 꽃꽂이를, $1의 몸을 사용해 시키기를 원한다…… 는, 저, 화내고 있어……?
$^(.+?)は俺の大事な所を見ながら、ハサミに手を伸ばそうとする。$	$1는 나의 소중한 곳을 보면서, 가위에 손을 뻗으려고 한다.
$^そ、そんな格好の(.+?)がそんなことを……、こ、これも非日常だね！　でも今は遠慮するよ！$	그런 모습의$1가 그런 일을……, 이, 이것도 비일상이구나! 그렇지만 지금은 사양한다!
$^あのさ、(.+?)はエッチする前にシャワーを浴びる時、化粧は落とすの？$	그런데 말이야, $1는 엣치하기 전에 샤워를 받을 때, 화장은 떨어뜨리는 거야?
$^いや、なんか(.+?)らしくていいね。$	아니, 뭔가 $1인것 같고 좋다.
$^リラックスしてる？　(.+?)？$	릴렉스 하고 있어? $1?
$^今思ったんだけど、こんな格好でうつぶせてる(.+?)なんてあんまり見ないし、いっぱい見ておこうかな。$	지금 생각한 것이지만, 이런 모습으로 엎드리고 있는$1은 그다지 보지 않고, 가득 봐 둘까.
$^(.+?)がエステを行っている女性にそう問いかけるが、その人は俺が首を振るのを見て、困ったような笑みを浮かべる。$	$1가 에스테틱을 실시하고 있는 여성에 그렇게 물어 보지만, 그 사람은 내가 고개를 젓는 것을 봐, 곤란한 것 같은 미소를 띄운다.
$^えー、そう言われてもね。(.+?)の体の事はじっくり見ておきたいし。$	네―, 그런 말을 들어도 말야. $1의 몸의 일은 차분히 봐 두고 싶고.
$^そっか。じゃ大人として(.+?)にエッチな事をしようか？$	그래. 그러면 어른으로서 $1에 엣치한 일을 할까?
$^(.+?)もそうなのかな？$	$1도 그런 것일까?
$^ほら(.+?)、周りを見て……。$	이봐요 $1, 주위를 봐…….
$^クラブでもこの格好はひときわ目立っていた。周りのお客様達がちらちらと(.+?)に熱い視線を送っていた。$	클럽에서도 이 모습은 한층 눈에 띄고 있었다. 주위의 고객들이 힐끔힐끔와 $1에 뜨거운 시선을 보내고 있었다.
$^(.+?)もそれを感じているのか、少しでも視線を避けようと時折身をよじっている。$	$1도 그것을 느끼고 있는지, 조금이라도 시선을 피하려고 때때로 몸을 비틀고 있다.
$^しかし、(.+?)の思いとは裏腹に、それが更に周りの興奮を煽っていた。$	그러나, $1의 생각과는 정반대로, 그것이 더욱 주위의 흥분을 부추기고 있었다.
$^みんな(.+?)に注目してるね。$	모두 $1에 주목하고 있네요.
$^いや、でも、女の人も(.+?)のこと見てるよ？　それも結構な数。$	아니, 그렇지만, 여자도 $1의 일 보고 있어? 그것도 상당한 수.
$^見られ続ける事に興奮してきたのか、(.+?)の呼吸が荒くなる。$	계속 볼 수 있는 일에 흥분해 왔는지, $1의 호흡이 거칠어진다.
$^(.+?)が注目されてると思うと、嬉しくなるね。$	$1가 주목받고 있다고 생각하면, 기뻐지네요.
$^あれ、(.+?)はお裁縫中なんだ。$	저것, $1는 재봉중이다.
$^(.+?)が何が好きとか、何が得意とかわかるようになるからね。$	$1가 무엇을 좋아한다던가, 무엇이 이익이라든지 알게 되니까요.
$^地味かどうかはともかく、(.+?)はこつこつとした仕事が得意そうだなって。$	수수한가 어떤가는 차치하고, $1는 톡톡 한 일이 자신있는 것 같다 하고.
$^熱心だね、(.+?)は。$	열심이다, $1는.
$^そんな風に気にする(.+?)の真面目さなら大丈夫だよ。$	그런 식으로 신경쓰는 $1의 성실함이라면 괜찮아.
$^(.+?)、今日はなんの針仕事？$	$1, 오늘은 무슨 재봉?
$^(.+?)が作ったものにガッカリなんてしないよ。$	$1가 만든 것에 실망 같은거 하지 않아.
$^そういうこと。さすが(.+?)は頭の回転が速いね。$	그런 일. 과연$1은 머리의 회전이 빠르다.
$^(.+?)は今でも充分魅力的だけどね。$	$1는 지금도 충분히 매력적이지만 말야.
$^(.+?)を褒めない人は、きっと見る目がないんだ。$	$1를 칭찬하지 않는 사람은, 반드시 보는 눈이 없다.
$^(.+?)、調子はどうだい？$	$1, 상태는 어때?
$^ははっ、真っ赤になってる。可愛いな、(.+?)は。$	는 하, 새빨갛게 되어 있다. 사랑스럽다, $1는.
$^(.+?)なら喜んでやってくれそうだね。$	$1라면 기꺼이 해 줄 것 같네.
$^うん、(.+?)が自信作と言うだけあって素晴らしいよ。$	응, $1가 자신작이라고 하는 만큼 훌륭해.
$^うん、(.+?)の言っている事は正しいよ。$	응, $1가 말하고 있는 일은 올발라.
$^そうだね。(.+?)の花嫁修業にもなるし。$	그렇다. $1의 신부 수업으로도 되고.
$^……ごめん。(.+?)は優しい子だと思ってるから。$	…… 미안. $1는 상냥한 아이라고 생각하고 있기 때문에.
$^真面目だね、(.+?)は。$	성실하다, $1는.
$^そういう(.+?)の生真面目さに好感が持てるね。$	그러한 $1의 고지식함에 호감을 가질 수 있는군.
$^人は人、(.+?)は\1だろ？$	사람은 사람, $1는 $1일 것이다?
$^だから(.+?)はそのままでいいんだよ。$	그러니까 $1는 그대로 좋아.
$^ははっ、(.+?)に教えられちゃったな。$	는 하, $1에 배워져 버렸군.
$^ありがとうな、(.+?)$	고마워요, $1
$^(.+?)、お腹が空いた～！$	$1, 배가 고픈~!
$^待ちきれないなあ、(.+?)。$	기다릴 수 없구나, $1.
$^味見でお腹が膨れるのはもったいないかな。せっかくの(.+?)の手料理だし。$	맛보기로 배가 부푸는 것은 아까울까. 모처럼의$1의 손요리이고.
$^(.+?)と俺の？$	$1와 나의?
$^照れちゃって可愛いなあ、(.+?)は。$	수줍어 버려 사랑스럽다, $1는.
$^美味しそうだなー、(.+?)。$	맛있을 것 같다, $1.
$^いや、(.+?)が頑張ってるところを見に来たんだ。$	아니, $1가 노력하고 있는 곳을 보러 온 것이다.
$^いや、(.+?)は料理上手だし、味見は必要ないよ。$	아니, $1는 요리 능숙하고, 맛보기는 필요없어.
$^(.+?)は何を読んでるんだ？$	$1는 무엇을 읽고 있지?
$^本を読むよりもいい方法があるよ、(.+?)。$	책을 읽는 것보다도 좋은 방법이 있어, $1.
$^詳しいね、(.+?)は余程の推理小説好きなんだね。$	자세하다, $1는 상당한 추리소설을 좋아하는 것이구나.
$^その小説、(.+?)は犯人の目星はついてる？$	그 소설, $1는 범인의 목표는 붙어 있어?
$^ずいぶんと熱心に本を読んでいるんだね、(.+?)？$	대단히 열심히 책을 읽고 있는 것이군, $1?
$^そうか、(.+?)は熱心なんだ。$	그런가, $1는 열심인 것이다.
$^(.+?)は、読書は好きな方なの？$	$1는, 독서는 좋아하는 (분)편이야?
$^(.+?)は華道に少し慣れてきた？$	$1는 화도에 조금 익숙해져 왔어?
$^どうしたの(.+?)、何か考え込んだるみたいだけど。$	왜$1, 뭔가 생각 붐빈 같지만.
$^なるほど……深いな、(.+?)は。$	과연…… 깊다, $1는.
$^うん、(.+?)ならやれるって感じ取れるよ。$	응, $1라면 할 수 있다 라고 감지할 수 있다.
$^熱心だなあ、(.+?)は。$	열심이다, $1는.
$^(.+?)は可愛いことを言うなあ。$	$1는 사랑스러운 말을 하지마아.
$^いや、(.+?)はこの花に負けないほど可愛いよ。$	아니, $1는 이 꽃에 지지 않을 정도 사랑스러워.
$^へえーっ！　(.+?)自身をイメージにしたのか！$	헤엣! $1 자신을 이미지로 했는가!
$^いや、活け花も(.+?)も同じぐらい可愛いし可憐だよ！$	아니, 활꽃도 $1도 같은 정도로 사랑스럽고 가련해!
$^(.+?)もこの花も美しくて可憐だよ。$	$1도 이 꽃도 아름답고 가련해.
$^はは、楽しみにしてるよ、(.+?)。$	는은, 기대하고 있다, $1.
$^ふむふむ。(.+?)が活け花をする手つきが色っぽくていいな。$	흠흠. $1가 활꽃을 하는 손놀림이 요염하고 좋은데.
$^その時は、また(.+?)に新しいのを活けてもらうよ。$	그 때는, 또 $1에 새로운 것을 활라고 받는다.
$^うん。(.+?)もこの活け花みたいに美しくなったよ。$	응. $1도 이 활꽃같이 아름다워졌어.
$^(.+?)がもっと綺麗になるのなら、化粧品ぐらい安いものだよ。$	$1가 좀 더 예쁘게 된다면, 화장품 정도싼 것이야.
$^(.+?)を磨くために必要なものなら、なんだって用意するよ。$	$1를 닦기 위해서(때문에) 필요한 것이라면, 뭐든지 준비한다.
$^おっ、今日の(.+?)のメイクはいい感じだな。$	오늘의$1의 메이크는 좋은 느낌이다.
$^(.+?)は元の素材がいいんだから、控えめで十分綺麗だよ。$	$1는 원래의 소재가 좋기 때문에, 소극적이어 충분히 깨끗해.
$^じっと化粧箱を見て、どうしたんだい(.+?)？$	가만히 화장 도구 상자를 봐, 어떻게 한 거야$1?
$^(.+?)はその口紅が気に入ったのかい？$	$1는 그 입다홍색이 마음에 들었는지?
$^良かった。実はそれ、(.+?)に似合いそうな色だなと思って手配したんだ。$	좋았다. 실은 그것, $1에 어울릴 것 같은 색이다라고 생각해 준비한 것이다.
$^嬉しそうだな。そんなに(.+?)の好みと合ってたんだ？$	기쁜 듯하다. 그렇게 $1의 기호와 맞고 있었던 것이야?
$^ははは、じゃあ次も(.+?)が喜びそうな物を仕入れてみるよ。$	하하하, 그러면 다음도 $1가 기뻐할 것 같은 것을 매입해 본다.
$^ふふ。そうやって照れる(.+?)は可愛いよね。$	후후. 그렇게 수줍은$1은 사랑스러운이지요.
$^ただでさえ可愛い(.+?)の素顔が、より美しくなっていくのを見るのが楽しいんだって。$	그렇지 않아도 사랑스러운$1의 본모습이, 보다 아름답게 되어 가는 것을 보는 것이 즐겁다고.
$^ははっ、茹で上がったみたいになってる。可愛いなあ、(.+?)は。$	는 하, 익은 것 같이 되어 있다. 사랑스럽다, $1는.
$^最近の(.+?)のメイク、上手くなったね。$	최근의$1의 메이크, 능숙해졌군요.
$^うっ、ちょっと皮肉が入って無いか(.+?)？$	조금 야유가 들어가 있지 않은가$1?
$^いや、改めてみると(.+?)って綺麗だし、可愛いなって思ったんだ。$	아니, 재차 보면$1은 예쁘고, 사랑스럽다라고 생각한 것이다.
$^で、(.+?)は可愛くて綺麗だ。肌のキメも細やかだし、俺好みだよ。$	그리고, $1는 사랑스럽고 예쁘다. 피부의 살결도 자그마하고, 내 취향이야.
$^わかってくれて嬉しいよ、(.+?)。$	알아 주어 기뻐, $1.
$^やあ(.+?)、今日も綺麗で可愛いね。$	야 $1, 오늘도 예쁘고 사랑스럽다.
$^(.+?)が綺麗になるためなら、値段なんて気にしていられないよ。$	$1가 예쁘게 되기 위해서(때문에)라면, 가격 같은거 신경쓰고 있을 수 없어.
$^うん。(.+?)の可愛い笑顔を見ているだけで、俺は充分だよ。$	응. $1의 사랑스러운 웃는 얼굴을 보고 있는 것만으로, 나는 충분해.
$^うん、さすが(.+?)、よくわかってらっしゃる。$	응, 과연 $1, 잘 알고 계신다.
$^ならいいけど。綺麗になった(.+?)を見るのが楽しみだな。$	라면 좋지만. 예쁘게 된 $1을 보는 것이 기다려진다.
$^(.+?)は素で綺麗なんだから当然だろ。$	$1는 순수하고 예쁘니까 당연할 것이다.
$^どうかな(.+?)、エステは気持ちいい？$	어떨까 $1, 에스테틱은 기분이 좋아?
$^(.+?)はエステを受けてみて、なにか変わったかな？$	$1는 에스테틱을 받아 봐, 뭔가 바뀌었을까나?
$^気持ち良さそうだね、(.+?)。$	기분 좋은 것 같다, $1.
$^見事的中か。さすが(.+?)、メイドの鑑だね。$	훌륭히 적중인가. 과연$1, 메이드의 귀감이구나.
$^あははっ、(.+?)は可愛いなあ。$	아하하, $1는 사랑스러운데.
$^(.+?)はエステが気に入ったみたいだね。$	$1는 에스테틱이 마음에 든 것 같다.
$^ははっ、安心したよ、(.+?)。$	는 하, 안심했어, $1.
$^なかなか忙しそうだね、(.+?)。$	꽤 바쁜 것 같네, $1.
$^あはは……(.+?)の腰が痛むと、よ、夜伽の時とか……ね？$	아하하……$1의 허리가 아프면, 바, 밤시중때라든지 말야?
$^うん、ありがたいよ、(.+?)。$	응, 고마워, $1.
$^ははっ、(.+?)の冗談がわかるように、俺も頑張るよ。$	는 하, $1의 농담을 알 수 있도록(듯이), 나도 노력한다.
$^うん？　ぼんやりしてどうしたのかな、(.+?)？$	응? 멍하니 해 왜일까, $1?
$^うん、気を遣ってくれてありがとう、(.+?)。$	응, 배려를 해 주어 고마워요, $1.
$^お疲れさま、(.+?)。$	수고 하셨습니다, $1.
$^ははっ、(.+?)は潔癖症なのかな。$	는 하, $1는 결벽증인 것일까.
$^(.+?)、シーツは畳み終わったんだね……どうしたの、嬉しそうだね。$	$1, 시트를 개는건 끝난것같네…… 무슨일이야, 기분이 좋아보이는데.
$^へえ、シーツの色からそんな風に感じるって(.+?)はすごい想像力だな。$	에 네, 시트의 색으로부터 그런 식으로 느낀다 라는 $1은 굉장한 상상력이다.
$^ふふ……(.+?)の笑顔を見ていると、俺も気持ち良くなってきたよ。$	후후……$1의 웃는 얼굴을 보고 있으면, 나도 기분 좋아져 왔어.
$^嬉しいよ、(.+?)……夜が楽しみだ。$	기뻐, $1…… 밤이 기다려진다.
$^いや、迷惑は掛かっていないって。真面目すぎるんだよ、(.+?)は。$	아니, 폐는 걸려있지 않다고. 너무 성실한거야, $1는.
$^あのさ、(.+?)。そういう風に自分のせいだと考えるのはやめようよ。$	그런데 말이야, $1. 그러한 식으로 자신의 탓이라고 생각하는 것은 그만두자.
$^あれ、(.+?)が鼻歌なんて珍しいね。機嫌が良いのかな？$	저것, $1가 콧노래 같은거 드물다. 기분이 좋은 것인지?
$^うん、ありがとう、(.+?)。$	응, 고마워, $1.
$^そう言ってくれるとご主人冥利に尽きるよ、(.+?)。$	그렇게 말해 주면 주인 명리에 다하는, $1.
$^掃除に洗濯とよく働いてくれるね、(.+?)。$	청소에 세탁과 잘 일해 주네요, $1.
$^おっ、(.+?)にそんなことを言われると舞い上がっちゃうよ。$	$1에 그런 말을 들으면 들떠 버린다.
$^ほ、本気にしちゃうそうだよ、(.+?)……。$	진심으로 해 버리는 것 같아, $1…….
$^どうしたの、(.+?)？$	무슨 일이야, $1?
$^はは……か、変わった趣味だね、(.+?)って。$	는은…… 바, 바뀐 취미구나, $1는.
$^(.+?)の目が泳いでいる気がするな。$	$1의 눈이 헤엄치고 있는 생각이 드는구나.
$^(.+?)、どうしたんだ、考え込んでるみたいだけど。$	$1, 어떻게 한 것이다, 골똘히 생각하고 있는 것 같지만.
$^(.+?)、模様替えは捗ってる？$	$1, 재배치는 진전되고 있어?
$^うーん、(.+?)の好きなようにやってくれればいいよ。$	응, $1가 좋아하는 것 같게 해 주면 좋아.
$^俺は(.+?)がどんな風に模様替えをしても、文句はないよ。$	나는$1이 어떤 식으로 재배치를 해도, 불평은 없어.
$^じゃあこうしよう。(.+?)の好みで配置してくれ。それでいいから。$	자 이렇게 하자. $1의 기호로 배치해 줘. 그것으로 좋으니까.
$^(.+?)、模様替えはどうかな？$	$1, 재배치는 어떨까?
$^ずいぶん真剣にやってるね、(.+?)。$	대단히 진검에 하고 있네요, $1.
$^うん、(.+?)はしっかり勉強したから大丈夫だよね。$	응, $1는 확실히 공부했기 때문에 괜찮네요.
$^ははっ……まあ、なんか、そういうところは(.+?)らしいよね。$	는 하…… 뭐, 뭔가, 그러한 곳은$1인것 같지요.
$^模様替え、頑張ってるね、(.+?)。$	재배치, 노력하고 있네요, $1.
$^希望は特にないかな。(.+?)がいいなって思った物で揃えて。$	희망은 특히 없을까. $1가 좋다라고 생각한 것으로 가지런히 해.
$^(.+?)が模様替えしてくれた部屋なら、俺はなんだって喜ぶよ。$	$1가 재배치해 준 방이라면, 나는 뭐든지 기뻐한다.
$^模様替えはどうかな、(.+?)？$	재배치는 어떨까, $1?
$^そうか。(.+?)、ありがとう。$	그런가. $1, 고마워요.
$^(.+?)が一所懸命考えてくれたものなら、俺のお気に入りになりそうだね。$	$1가 열심히 생각해 준 것이라면, 나의 마음에 드는 것이 될 것 같네.
$^いや、俺は(.+?)の好みのインテリアでも良かったんだ。$	아니, 나는$1의 기호의 인테리어에서도 좋았던 것이다.
$^(.+?)の心が籠もった部屋か……すごく寛げそうだ。$	$1의 마음이 깃들인 방인가…… 굉장히 편히 쉴 수 있을 것 같다.
$^うん、嬉しいよ、(.+?)。$	응, 기뻐, $1.
$^ちょっと(.+?)、飲むペースが速くない？$	조금$1, 마시는 페이스가 빠르지 않아?
$^(.+?)と一緒だとお酒が進むね。$	$1와 함께라고 술이 진행되네요.
$^ええっ、俺とこうして過ごすのは嫌？　(.+?)は冷たいなあ。$	예, 나와 이렇게 하며 보내는 것은 싫어? $1는 차가운데.
$^あれ、今日の(.+?)はなんとなく機嫌がいいのかな？$	저것, 오늘의$1는 어딘지 모르게 기분이 좋은 걸까나?
$^ははっ、(.+?)はちょっと警戒気味だったもんな。$	는 하, $1는 조금 경계 기색이었다.
$^……のっけから大丈夫か、(.+?)？$	…… 처음부터 괜찮은가, $1?
$^(.+?)って酔うと、普段と違った可愛さがあるね？$	$1는 취하면, 평상시와 다른 사랑스러움이 있네요?
$^ちょっと本当に大丈夫か、(.+?)？$	조금 정말로 괜찮은가, $1?
$^うーん……かなり酔ってるね、(.+?)。$	응…… 꽤 취하고 있네요, $1.
$^……全然大丈夫そうじゃないよね、(.+?)。$	…… 전혀 괜찮아 그렇지 않지요, $1.
$^俺も、(.+?)の上達が嬉しいよ。$	나도, $1의 능숙이 기뻐.
$^もう手遅れだよ、俺は(.+?)に酔ってるんだからさ。$	이제(벌써) 뒤늦음이야, 나는$1에 취해 있기 때문에.
$^いつだって俺は(.+?)に本気だよ？$	언제라도 나는$1에 진심이야?
$^あれ、なんだか(.+?)らしくないね。$	저것, 뭔가$1인것 같지 않다.
$^あぁ、俺も。(.+?)になら、恥ずかしいところ見られても平気だな。$	아, 나도. $1에라면, 부끄러운 곳 볼 수 있어도 괜찮다.
$^無理しなくていいんだよ、(.+?)。$	무리하지 않아도 괜찮아, $1.
$^それはだって、俺は(.+?)の事が大好きだからね。$	그것은이래, 나는$1의 일을 아주 좋아하니까.
$^はは、じゃあお願い。接客の練習とはいえ、(.+?)にお酒を注いでもらえるなんて幸せだなぁ。$	는은, 그러면 부탁. 접객의 연습이라고는 해도, $1에 술을 따라 받을 수 있다니 행복하다.
$^ありがとう、それは嬉しいな。……でも(.+?)、酔ってるからって、そんな事言って、後で後悔しない？$	고마워요, 그것은 기쁜데. …… 그렇지만$1, 취하고 있기 때문에 라고, 그런 일 말해, 다음에 후회하지 않아?
$^(.+?)って、そういう事をあまり言わなそうに見えて、結構はっきり言うよね。$	$1는, 그런 일을 그다지 말하지 않는 듯이 보여, 상당히 분명히 말하네요.
$^しないしない、誓って言うよ。(.+?)にだけだから、本当に。$	안 해 안 해, 결코 말한다. $1에만이니까, 정말로.
$^(.+?)はどうしてほしいの？$	$1는 어째서 가지고 싶은거야?
$^(.+?)が大胆になってる……これもお酒のせい、かな……$	$1가 대담하게 되어있는…… 이것도 술의 탓, 일까……
$^ふふ、(.+?)、様になってきたね。$	후후, $1, 님이 되었군요.
$^うぅん、好きな方か……。(.+?)に酔わされるのも楽しいだろうし、\1を酔わせるのも面白そうだし。$	응, 좋아하는 (분)편인가……. $1에 취해지는 것도 즐거울 것이고, $1를 취하게 하는 것도 재미있을 것 같고.
$^お願いするよ……まあ正直、(.+?)と一緒にいられるだけで、俺には充分だけどね。$	부탁하는…… 뭐 정직, $1와 함께 있을 수 있는 것만으로, 나에게는 충분하지만 말야.
$^(.+?)に全力で頑張られたら俺……場所なんか関係なく、本気になっちゃうかも……$	$1에 전력으로 노력해지면 나…… 장소 어쩐지 관계없이, 진지해져 버릴지도……
$^(.+?)は嫌なの？$	$1는 싫어?
$^そうかな？　(.+?)は丁寧で冷静だし、結構向いてるような気がするけどな。$	그럴까? $1는 정중하고 냉정하고, 상당히 향하고 있는 것 같은 생각이 들지만인.
$^何で(.+?)が顔が真っ赤になっているのかな？$	뭐 때문에 $1가 얼굴이 새빨갛게 되어 있는 것일까?
$^(.+?)は良く分かってるね。$	$1는 잘 알고 있구나.
$^(.+?)が教えてくれてるから、気持ち良いよ。$	$1가 가르쳐 주고 있으니, 기분 좋아.
$^うーん、(.+?)が相手だと、教わる方も大変そうだ。$	응, $1가 상대라고, 배우는 (분)편도 대단하다.
$^ん、なんだい(.+?)。$	응, 뭐야 $1.
$^あ、(.+?)寒くないかい？　風邪をひかないようにね？$	아, $1 춥지 않아? 감기 걸리면 안 되는데?
$^うーん、(.+?)を見てると段々興奮してくるなぁ……。$	으음, $1를 보니 점점 흥분되네…….
$^あ、そうか。(.+?)は大胆だなぁ、料理だけじゃなくて、自分も召し上がって欲しいとか……ね？$	아, 그래. $1는 대담하구나, 요리뿐만이 아니라 자기도 먹어달라는 건가……?
$^顔を真っ赤にして答える(.+?)。$	얼굴을 붉히며 대답하는 $1.
$^(.+?)は露出大好きな変態ですって、言ってみて？$	$1는 노출을 엄청 좋아하는 변태라고, 해볼래?
$^(.+?)の普段見せないような冷たく睨む視線を受け、俺は思わず謝ってしまうのだった……。$	$1의 평소엔 보여주지 않는 차갑게 노려보는 시선을 받고, 나는 무심코 사과하는 것이었다…….
$^な、なんか……耽美だね、(.+?)。$	뭐, 뭔가……감동적이네, $1.
$^すごい格好で花を生けている(.+?)をみて、思わず感想を漏らす。$	엄청난 모습으로 꽃꽂이를 하는 $1를 보고 무심코 감상을 말한다.
$^(.+?)はその言葉を聞いて、元々赤かった顔がより赤く染まってしまう。$	$1는 그 말을 듣고, 빨갛던 얼굴이 더 빨갛게 물들어 버린다.
$^あれ？　そうだった？　でも(.+?)が魅力的に映ってるのは、本当だよ？$	어라? 그랬어? 그래도 $1가 매력적으로 보이는 건 사실이라구?
$^そう言わずにさ。もっと見せてよ、(.+?)が花を生けるところをさ……$	그러지 말고. 더 보여 줘, $1가 꽃을 꽂는 곳을 말이야…
$^あ、(.+?)はそのままで綺麗だから大丈夫だよ？　その格好もすごく良いし……$	아, $1는 그대로도 예쁘니까 괜찮다구? 그 모습도 엄청 좋고…
$^女の子ってエッチの前、シャワー浴びるよね？　(.+?)は化粧とか、落とすの？$	여자는 섹스하기 전에 샤워하지? $1는 화장 해, 아님 지워?
$^この時間はエステということで、目の前では(.+?)が少し固いながらも、自分の体をほぐす手に身をゆだねている。$	이 시간은 에스테라는 점에서, 눈 앞에서는 $1가 조금 굳어있으면서도 마사지를 받으려고 몸을 맡기고 있다.
$^エステティシャンの指示に従って、(.+?)が体勢を変える。$	에스테티션의 지시에 따라, $1가 자세를 바꾼다.
$^この格好の(.+?)が動くと、図らずも色々な所が目に入り、なかなか目に楽しい。$	이 모습의 $1가 움직이면, 본의 아니게 여러 곳이 눈에 들어왔고, 꽤나 눈이 즐겁다.
$^せっかくだからじっくり(.+?)のお尻を見せてもらおうかな？$	모처럼이니까 느긋하게 $1의 엉덩이를 봐도 될까?
$^思いがけず(.+?)から許しが出て、俺はそれなら、とじっくりと鑑賞させてもらう。$	뜻밖에 $1의 허가가 나오고, 나는 그럼, 하고 느긋하게 감상한다.
$^……どう(.+?)、恥ずかしい？$	…… 어때 $1, 부끄러워?
$^(.+?)のお尻は綺麗だね、ふふ……$	$1의 엉덩이는 예쁘네, 후후……
$^あ、ダメだよ(.+?)。そんな風に隠しちゃ。見せて見せて？$	아, 안 돼 $1. 그렇게 숨기면. 보여 줘 보여 줘?
$^(.+?)が恥ずかしがるのが見たいからかなぁ。$	$1가 부끄러워하는 걸 보고 싶었기 때문이려나.
$^模様替えの最中、荷物を運ぶ手を止めると、(.+?)がおずおずと話しかけてくる。$	꾸미는 도중, 물건을 옮기는 손을 멈추고 $1가 우물쭈물 말을 걸어 온다.
$^ん？　どうしたの、(.+?)？$	응? 왜 그래, $1?
$^うーん、(.+?)が何を言いたいのか分からないな……$	으음, $1가 뭘 말하고 싶은지 모르겠네…
$^ああ、そうか。(.+?)寒いの？$	아아, 그런가. $1 추워?
$^(.+?)が急いでこぼれたお酒を拭き始める。$	$1이 급히 쏟은 술을 닦기 시작한다.
$^ダメ。それでさ(.+?)、ワカメ酒って知ってる……？$	안 돼. 그래서 $1, 미역 술이라고 알아……?
$^俺は(.+?)を引き寄せると、わかめ酒が何なのか説明する。$	나는 $1를 끌어들여 미역 술이 무엇인지 설명한다. (여자 거기에 부어 마시는 것)
$^(.+?)、どうしたの？$	$1, 왜 그래?
$^ダメじゃないよ。そういうところが(.+?)の可愛いところだよ。$	안 되지 않아. 그런 부분이 $1의 사랑스러운 점이야.
$^もしもし、(.+?)、聞こえてる？$	여보세요, $1, 들려?
$^そうか……(.+?)は裁縫好きなんだろうな。$	그런가…… $1는 재봉을 좋아하는 거네.
$^欲張りなんて思わないよ、(.+?)。$	욕심쟁이라고는 생각 안 해, $1.
$^仕事に精が出るね、(.+?)$	일 열심히 하네,$1
$^(.+?)は良い手つきで仕事してるから大丈夫だよ。$	$1는 좋은 솜씨로 일하고 있으니까 괜찮아.
$^あはは、そういうことか。(.+?)が作ってくれたのなら嬉しいよ。$	아하하, 그런 건가. $1가 만들어 준 거라면 기뻐.
$^うん、楽しみにしてるよ、(.+?)。$	응, 기대하고 있을게, $1.
$^(.+?)、お裁縫の調子はどうかな。$	$1, 재봉은 잘 되고 있으려나.
$^素直に喜ぶところも(.+?)のいいところだからね。$	솔직하게 기뻐하는 부분도 $1의 좋은 점이니까 말야.
$^ありがとう、(.+?)。その言葉だけでも充分嬉しいよ。$	고마워, $1. 그 말만이라도 충분히 기뻐.
$^(.+?)の作ったものなら、部屋いっぱいに溢れても構わないよ。$	$1가 만든 거라면, 방안에 가득 넘쳐도 괜찮아.
$^ふふ……可愛いな、(.+?)は。$	후후…… 사랑스럽네, $1는.
$^一点特化って才能のうちだし、(.+?)が得意ならそれでいいと思うよ。$	한가지를 잘하는 것도 재능이고, $1가 자신있으면 그걸로 좋다고 생각해.
$^へえ、(.+?)は包丁使うの上手だね。$	헤에, $1는 부엌칼 쓰는 거 잘하네.
$^うん、(.+?)は真面目でいい子だね。$	응, $1는 성실하고 착한 아이네.
$^大丈夫。(.+?)が一所懸命作ってくれた料理なら、何だって美味しいさ。$	괜찮아. $1가 열심히 만들어 준 요리라면, 뭐든지 맛있는 거야.
$^(.+?)、今日もお料理を頑張ってるね。$	$1, 오늘도 요리 열심히 하네.
$^いや、(.+?)のその手つきが可愛いんだよ。$	아니, $1의 그 손놀림이 귀엽다구.
$^狙わなくても(.+?)は可愛いからね。$	노리지 않아도 $1는 귀여우니까 말야.
$^そうやって喜ぶ(.+?)を見るの、俺は好きだな。$	그렇게 기뻐하는 $1를 보는 거, 난 좋아해.
$^あははっ、照れても可愛いんだよな、(.+?)って。$	아하핫, 부끄러워하는 것도 사랑스럽네, $1는.
$^(.+?)、料理してるの？$	$1, 요리하고 있어？
$^ちょっと(.+?)と話したくなったんだけど、ダメかな？$	잠깐 $1와 이야기하고 싶어졌는데, 안 되려나？
$^ははっ、退屈だから来たんだよ。(.+?)に会いたくてさ。$	하핫, 지루해서 온 거야. $1를 만나고 싶어서 말야.
$^(.+?)、料理は順調？$	$1, 요리는 잘 돼?
$^俺も今度、(.+?)に何か作ろうかなぁ。何か食べたいものある？$	나도 이번엔, $1에게 뭔가 만들어 줄까. 뭐 먹고 싶은 거 있어?
$^じゃあ、今はあんまりお腹が空いてないから、(.+?)が食べたいな？	그럼, 오늘은 그리 배가 안 고프니까, $1를 먹고 싶은데?
$^(.+?)、大丈夫？$	$1, 괜찮아?
$^うん、俺ももっと勉強しておくよ。ありがとうね、(.+?)。$	응, 나도 좀 더 공부할게. 고마워, $1.
$^いやいや、(.+?)の言う通りだよ。俺もちゃんとしなくちゃね。$	아니 아니, $1가 말한 대로야. 나도 제대로 하지 않으면 말야.
$^あれ、(.+?)、ずいぶんエッチな本を……$	어라, $1, 꽤나 야한 책을……
$^そっか、(.+?)もそういうの読むんだ。$	그런가, $1도 그런 걸 읽는구나.
$^(.+?)、本を読んでるの？$	$1, 책 읽는 중이야?
$^そっか。真面目だね、(.+?)は。$	그래. 성실하네, $1는.
$^大丈夫だと思うよ。(.+?)は頑張り屋さんだからね。$	괜찮다고 생각해. $1는 노력파니까.
$^はは、(.+?)はもっと自信をもっていいと思うけどなぁ。$	하하, $1는 좀 더 자신을 가져도 된다고 생각하는데.
$^(.+?)～、何を読んでるのかな？$	$1~ 뭐 읽고 있는 거야?
$^それに、小説も立派な勉強だよ、気にしないで、(.+?)……で、何を読んでいたの？$	그리고, 소설도 훌륭한 공부야, 신경쓰지 마, $1…… 그래서, 뭐 읽고 있었어?
$^今日も熱心だね、(.+?)$	오늘도 열심히네, $1
$^うん、嬉しいよ。(.+?)がちゃんとそういうことも、勉強してくれてさ。$	응, 기뻐. $1가 제대로 그런 것도 공부해 줘서 말야.
$^ありがとう、そんなこと言ってくれるの(.+?)ぐらいだよ。$	고마워, 그렇게 말해 주는 건 $1뿐이야.
$^はは、大げさだな、(.+?)は。$	하하, 과장이 심하네, $1는.
$^そ、そこまで言われるとなんだか恥ずかしくなるね……(.+?)も可愛いよ。$	그, 그렇게 까지 들으면 왠지 부끄러워지네…… $1도 사랑스러워.
$^いやいや、(.+?)のほうが。$	아니 아니, $1 쪽이.
$^(.+?)、どう？　本は勉強になる？$	$1, 어때? 책은 공부가 돼?
$^そっか……(.+?)は、根っからの働き者なんだなぁ。$	그런가……$1는 타고난 일꾼이구나.
$^本当に可愛いなぁ……(.+?)は。$	정말 사랑스럽네…… $1는.
$^(.+?)、華道はどんな感じ？$	$1, 꽃꽂이는 어떤 느낌이야?
$^(.+?)が思うとおりにやるといいんじゃないかな？$	$1가 하고싶은대로 하면 되는 거 아닐까?
$^(.+?)は可愛いから大丈夫、生ける花もきっと可愛いよ。$	$1는 이쁘니까 괜찮아, 살리는 꽃도 분명 이뻐.
$^はは、実は俺もよくわかってないけど、華道をしてる(.+?)は素敵だと思うよ。$	하하, 사실 나도 잘 모르지만, 꽃꽂이를 하고 있는 $1는 멋지다고 생각해.
$^花も可愛いけど(.+?)ほどじゃないね。$	꽃도 이쁘지만 $1 만큼은 아니네.
$^どっちも可愛いけど、俺には(.+?)のがちょっと魅力的だな。$	어느 쪽도 이쁘지만, 나한테는 $1가 좀 더 매력적이네.
$^熱心だね、(.+?)。$	열심히네, $1.
$^うん。可憐で、(.+?)みたいに見えてきた。$	응. 가련해서, $1처럼 보이네.
$^楽しそうだね、(.+?)。$	즐거워 보이네, $1.
$^はは、それもそっか。俺もかなり好きになってきたよ。(.+?)の生けた花。$	하하, 그것도 그런가. 나도 꽤 좋아하게 되었어. $1가 꽂은 꽃.
$^うん、見てると穏やかになるから。(.+?)と同じぐらい好きだよ。$	응, 보고 있으면 편안하게 되니까. $1와 같은 정도로 좋아해.
$^(.+?)、どう？　華道は。$	$1, 어때? 꽃꽂이는.
$^(.+?)、華道は慣れてきた？$	$1, 꽃꽂이는 익숙해졌어?
$^……集中してるね、(.+?)。$	…… 집중하고 있네, $1.
$^ん？　いや、ついさっきだよ。(.+?)を眺めてた。$	응? 아니, 방금 전에. $1를 보고 있었어.
$^(.+?)、出来上がった？$	$1, 다 됐어?
$^好きってほどじゃなかったけど、(.+?)が生けたのなら好きになりそう。$	좋아하는 것 정도는 아니었지만, $1가 만든 거라면 좋아하게 될 거 같아.
$^(.+?)、華道の調子はどう？$	$1, 꽃꽂이는 어때?
$^この花、どこか(.+?)に似てるかもね。$	이 꽃, 어딘가 $1를 닮았을지도 모르겠네.
$^はは、赤くなった(.+?)は花より可愛いよ。$	하하, 붉어진 $1는 꽃보다 사랑스러워.
$^でも本当に、花も綺麗だよ。この調子で頑張って、(.+?)に負けないぐらい可愛くなるといいね。$	그런데 정말, 꽃도 예뻐. 이 상태로 노력해서, $1한테 지지 않을 정도 귀여워지면 좋겠네.
$^とりあえず俺の部屋だけでも、(.+?)の花で埋めちゃってよ。素敵だと思うからさ。$	일단 내 방만이라도, $1의 꽃으로 채워 줘. 멋지다고 생각하니까.
$^(.+?)、化粧してるの？$	$1, 화장하고 있어?
$^謝らなくていいんだよ。そうだな……(.+?)は可愛くなりたくない？$	사과 안 해도 돼. 그러네……$1는 귀여워지고 싶지 않아?
$^大人っぽいね、(.+?)。$	어른스럽네, $1.
$^(.+?)？　ちょ、ちょっと化粧が濃くないかな？$	$1? 조, 좀 화장이 진하지 않아?
$^そんなに熱心にやらなくても、(.+?)は十分可愛いよ。$	그렇게 열심히 안 해도, $1는 충분히 사랑스러워.
$^うん、大変そうだけど……(.+?)がもっと可愛くなったら、俺は嬉しいよ。$	응, 힘들겠지만……$1가 좀 더 사랑스러워진다면, 난 기쁠 거야.
$^(.+?)は好きだよ？$	$1는 좋아한다구?
$^もちろんどっちも。あと性格も。全部最高だよ、(.+?)は。$	물론 둘 다. 그리고 성격도. 전부 최고야, $1는.
$^そうだね。すっぴんでも可愛いけど、化粧するとより見惚れちゃうね。本当に綺麗だよ、(.+?)。$	그러네. 쌩얼도 사랑스럽지만, 화장하면 더 푹빠져버리네. 정말 예뻐, $1.
$^(.+?)、化粧はどんな感じ？$	$1, 화장은 어떤 느낌?
$^化粧で好きになるわけじゃないからね。俺が好きなのは(.+?)だよ。$	화장으로 좋아하게 되는 게 아니니까 말야. 내가 좋아하는 건 $1라구.
$^そうかな？　でも俺は(.+?)の化粧したところも見たいけどね。$	그런가? 그런데 난 $1의 화장한 모습도 보고 싶은데 말야.
$^(.+?)、化粧品は足りてる？　遠慮なく使っていいからね。$	$1, 화장품은 충분해? 사양말고 써도 되니까.
$^特に(.+?)にはね？$	특히 $1에게는 말야?
$^はは、どうせ消耗品だから。どうせなら(.+?)の肌を大事にしてよ。$	하하, 어차피 소모품이니까. 이왕이면 $1의 피부를 소중하게 해줘.
$^(.+?)、もう終わった？$	$1, 벌써 끝났어?
$^可愛いよ。(.+?)はもともと可愛いけど、大人びて見える。素敵だよ。$	사랑스러워. $1는 원래 사랑스러운데, 지금은 어른스러워 보여. 멋지네.
$^え？　耐えられないって何に？　今(.+?)、エステを受けてるだけでしょ？$	에? 못 참겠다니 뭐가? 지금 $1, 에스테틱을 받고 있는 것 뿐이지?
$^慣れていないというか……(.+?)、なんだかいやらしい想像してない？　もしかして。$	익숙하지 않다고 할까……$1, 뭔가 야한 상상을 하고 있지 않아? 혹시.
$^(.+?)は可愛いなぁ。まあ、冗談だから気にしないで、ゆっくりエステを続けてよ。$	$1는 귀엽네. 뭐, 농담이니까 신경쓰지 말고, 느긋하게 에스테틱을 계속해.
$^ごめんごめん、(.+?)の反応が面白くて、ついついね。それじゃ、俺はお暇するよ。$	미안 미안, $1의 반응이 재밌어서, 나도 모르게 말야. 그럼, 나는 이만.
$^遠慮されても困るよ、(.+?)。そんな気遣いはいいから、しっかり綺麗になってよね。$	사양해도 곤란해, $1. 그런 걱정은 됐으니까, 더 예쁘게 되자.
$^ご主人様の俺がいいって言ってるんだから、何も問題なんてないよ。(.+?)が気にする事じゃないさ。$	주인님인 내가 좋다고 말하고 있잖아, 아무 문제 없어. $1가 신경쓸 일이 아냐.
$^そうそう。わかってきたじゃないか、(.+?)。$	그래 그래. 알게 되었네, $1.
$^どうしたの、(.+?)。もしかして、エステで感じるの？$	왜 그래, $1. 혹시, 에스테틱으로 느끼는 거야?
$^(.+?)が本当の事を言ってくれたら、俺も嬉しいだけどなぁ……$	$1가 진심을 말해 줬으면, 나도 기쁠텐데……
$^そっか。(.+?)がそうまで言うなら信じるよ。疑ってごめんね。$	그래. $1가 그렇게까지 말한다면 믿을게. 의심해서 미안해.
$^ん？　どうしたの、(.+?)。$	응? 왜 그래, $1.
$^え、冗談のつもりだったんだけど……。そこまで言われると、もう(.+?)の身体に触れざるを得ない気持ちになるな……$	에, 농담이었는데……. 그렇게 까지 말해주면, 이제 $1의 몸을 만지지 않으면 안되는 기분이 되네……
$^ふぅん……。絶対に耐えられないんだ？　今、(.+?)は……俺に触られると、絶対に耐えられない……$	흐음……. 절대로 못 참는다? 지금 $1는…… 내게 만져지면, 절대로 못 참는구나……
$^恥ずかしがっている(.+?)を見てると、こう……少しだけでもつついたりしたくなるなぁ……$	부끄러워하고 있는 $1를 보고 있으니, 이렇게…… 조금이라도 쿡쿡 찌르거나 하고 싶어지네……
$^反応が楽しい。真面目な(.+?)がくすぐったくて笑い転げるところなんて、いつでも見られるものじゃないからね。$	반응이 즐거워. 성실한 $1가 간지러워서 웃는 건, 언제든지 볼 수 있는 게 아니니까 말야.
$^確かに俺も恥ずかしいけど、(.+?)も一緒に恥ずかしい。ほら、誰も不幸じゃない。$	확실히 나도 부끄럽지만, $1도 같이 부끄러워. 봐, 아무도 불행하지 않아.
$^うん、だから(.+?)をからかってるんだけど。$	응, 그래서 $1를 놀리고 있는데.
$^はは、あ、でも(.+?)。あんまり気を緩めると……$	하하, 아, 그래도 $1. 너무 긴장을 풀면……
$^それでも嬉しいよ。ありがとう、(.+?)。$	그래도 기뻐. 고마워, $1.
$^そっか。それじゃあ(.+?)は、そのままどんどん綺麗になってね。$	그래. 그럼 $1는, 그대로 계속 예뻐져.
$^あぁ、大丈夫だよ。今(.+?)は、綺麗になるためにエステを受けてるんだからさ。$	아아, 괜찮아. 지금 $1는, 예쁘게 되려고 에스테틱을 받고 있는 거니까 말야.
$^遠慮なんかする必要はないよ。ダメならそもそも、(.+?)にエステなんかさせてないしさ。$	사양같은 거 할 필요 없어. 안 되는 거면 애초에, $1에게 에스테틱은 시키지 않았겠지.
$^いや、平気だよ。というか、真面目な(.+?)らしい気遣いだなって感心したところ。さすが、俺のメイドだって誇らしい気分だよ。$	아니, 괜찮아. 라고 할까, 성실한 $1다운 걱정이다 하고 감탄했어. 역시, 내 메이드라서 자랑스러운 기분이야.
$^ふふ、エッチな声だね、(.+?)。$	후후, 야한 목소리네, $1.
$^そんな、幻滅だなんてするわけないよ。むしろ、(.+?)の可愛い声が聞けてラッキーだなって思ってるくらい。$	그런, 실망이라니 할 리가 없어. 오히려, $1의 사랑스러운 목소리를 들을 수 있어 럭키-라고 생각하고 있을 정도야.
$^え？　別にいいじゃないか。(.+?)は、俺に喜んでもらえるのが嬉しい。俺は、可愛い\1が見られて嬉しい。$	에? 어차피 좋잖아. $1는, 내가 기뻐해 주는 게 기쁘다. 나는, 사랑스러운 $1를 볼 수 있어서 기쁘다.
$^(.+?)がどうしてもイヤっていうなら、エステ中に見たりしないけどね。\1を悲しませたいわけじゃないから。$	$1가 아무래도 싫다고 한다면, 에스테틱 중에 보거나 하지 않을게. $1를 슬프게 하고 싶은 건 아니니까.
$^じゃあ、(.+?)の恥ずかしいところも見てていいでしょ？$	그럼, $1의 부끄러운 모습을 봐도 되지?
$^うぅん……そんなつもりはないんだけどね。(.+?)が可愛いから、ついついそうしちゃうんだよ。$	으음…… 그럴 생각은 없는데 말야. $1가 사랑스러우니까, 나도 모르게 그렇게 해 버리는 거야.
$^うぅん、俺はいいかな。(.+?)が綺麗になった方が嬉しいしね。$	으음, 나는 됐으려나. $1가 예쁘게 되는 게 더 기쁘고.
$^そうだね。でも、男もエステか。考えた事もなかったな……(.+?)は、俺にエステに行ってほしい？$	그렇네. 그치만, 남자가 에스테틱인가. 생각한 적 없었어……$1는, 내가 에스테틱을 하면 좋아?
$^そうか。それじゃ今度、(.+?)と一緒にエステしてみようかな？$	그런가. 그럼 이번에, $1랑 같이 에스테틱을 해 볼까?
$^エステ気持ち良い、(.+?)？$	에스테틱 기분 좋아, $1?
$^……(.+?)、なんだかシンデレラみたいだね。$	……$1, 뭔가 신데렐라 같네.
$^うんうん。人目があろうがなかろうが頑張っている(.+?)には、いつか夢を叶えてくれる魔女がやってきてくれるよ。$	응 응. 남의 눈이 있든지 없든지 노력하는 $1에게는, 언젠가 꿈을 이뤄주는 마녀가 와 줄 거야.
$^ああ。頑張ってる(.+?)が報われないのはイヤだからね。$	아아. 노력하고 있는 $1가 보답받지 못하는 건 싫으니까 말야.
$^(.+?)はそんな感じだよね。大丈夫、俺は\1の頑張りをちゃんと見てるから。$	$1는 그런 느낌이지. 괜찮아, 나는 $1가 열심히 하는 걸 제대로 보고 있으니까.
$^いやぁ、それは大丈夫。(.+?)の事、信じてるから。$	아니, 그건 괜찮아. $1를, 믿고 있으니까.
$^俺は数々のメイドの中から、(.+?)を見つけるわけだ。それは大変そうだ。$	난 많은 메이드들 중에서, $1를 찾아내는 거야. 그건 큰일이겠네.
$^お、(.+?)が掃除してる……。ふふ、なんだか一生懸命頑張ってるな。$	어, $1가 청소하고 있어……. 후후, 뭔가 열심히 하고 있네.
$^(.+?)、結構独り言多いな……$	$1, 꽤나 혼잣말이 많네……
$^おーい、(.+?)。$	어~이, $1.
$^あの、(.+?)……？$	저기, $1……?
$^洗濯、楽しい？　(.+?)。$	빨래, 즐거워? $1.
$^それに、(.+?)が頑張って洗濯してくれたんだって思うと、余計にね。$	그리고, $1가 열심히 빨래를 해줬다고 생각하면, 더더욱.
$^あれ、どうしたの、(.+?)。$	어라, 왜 그래, $1.
$^なんだか(.+?)らしいな。$	뭔가 $1답네.
$^(.+?)の方の好きなやり方でやればいいと思うよ。$	$1가 좋아하는 방식으로 하면 된다고 생각해.
$^でも(.+?)は、どうしてそんな風に思ったの？$	그런데 $1는, 왜 그런 식으로 생각했어?
$^(.+?)は真面目だし、優しいからね。よくわかるよ。$	$1는 성실하고, 상냥하니까 말야. 잘 알아.
$^そっか。それで、(.+?)はどうするつもりなの？$	그래. 그래서, $1는 어떻게 할 생각이야?
$^ふふ、なんだか(.+?)らしいな。それじゃ、その調子でこれからもよろしくね。$	후후, 뭔가 $1답네. 그럼, 그렇게 앞으로도 잘 부탁해.
$^やあ、(.+?)。モップ掛けする姿が絵になるね……いかにもメイドさんって感じだね。$	이야, $1. 걸레질 하는 모습이 그림같네…… 그야말로 메이드라는 느낌이네.
$^そんな、気にしないでよ。(.+?)はいつも通り、仕事していて。$	그런, 신경쓰지 마. $1는 평소처럼 일하고 있어.
$^俺は楽しいから大丈夫。(.+?)はそのまま、掃除を続けて。$	난 즐거우니까 괜찮아. $1는 그대로 청소를 계속해.
$^うん、さっきまでちゃんと干していたからね。(.+?)って、洗濯は好きなのかな？$	응, 방금까지 잘 널어 뒀으니까. $1는 빨래를 좋아해?
$^(.+?)が楽しんで仕事をしてくれているみたいで、俺も嬉しいよ。$	$1가 즐겁게 일을 해 주고 있는 것 같아서, 나도 기뻐.
$^いやいや、是非(.+?)にやってほしい。俺も、その方が嬉しいし。$	아니 아니, 꼭 $1가 해주면 좋겠어. 나도 그 쪽이 기쁘고.
$^だ、大丈夫、(.+?)？　長い間、頑張ってるみたいだけど……$	괘, 괜찮아, $1? 너무 오래 열심히 하는 거 같은데……
$^それはそうだけどさ。頑張る(.+?)は素敵だけど……身体、壊さないように気を付けてね。$	그건 그렇지만 말야. 열심히 하는 $1는 멋지지만…… 몸이 상하지 않게 조심해.
$^そりゃ気に掛けるよ。(.+?)は俺にとって、大切なメイドだからね。$	그럼 걱정할래. $1는 나에게 있어서, 소중한 메이드니까.
$^いや、なんだか(.+?)を見てたら、俺もしたくなってさ。$	아니, 왠지 $1를 보고 있으면, 나도 하고 싶어져서 말야.
$^わかったよ。それじゃここは、(.+?)に綺麗にしてほしい。$	알았어. 그럼 여기는, $1가 깨끗하게 해줬으면 좋겠어.
$^やあ、(.+?)。なんだかずいぶん楽しそうだね。$	이야, $1. 뭔가 되게 즐거워 보이네.
$^(.+?)はいじらしいな。そんな風に言われたら、ドキドキしちゃうじゃないか。$	$1는 기특하네. 그런 식으로 말하면, 두근두근해 버리잖아.
$^それじゃ、俺も(.+?)も、お互いがいて幸せってわけだね。$	그럼, 나도 $1도, 서로가 있어서 행복하다는 거네.
$^(.+?)、大胆だね。\1の気持ちはわかったけど、とりあえず今は仕事を続けてくれ。$	$1, 대담하네. $1의 기분은 알겠지만, 일단 지금은 일을 계속해 줘.
$^あれ、(.+?)。なんだか大変そうだね。$	어라, $1. 힘들겠네.
$^そうだね。俺が余計な事したら、むしろ(.+?)に迷惑が掛かっちゃうよね。$	그렇네. 내가 쓸데없는 짓을 하면, 오히려 $1에게 실례가 되어 버리네.
$^いや、そういうわけじゃないけど……。(.+?)を助けてあげられたらなって思ってさ。$	아니, 그런 건 아니지만……. $1를 도와 줄 수 있으면 좋겠다고 생각해서 말야.
$^まあ、(.+?)はメイドだからね。助けてくれなかったら、むしろ悲しいかも。$	뭐, $1는 메이드니까. 도와주지 않으면 오히려 슬플지도.
$^(.+?)は本当、仕事熱心だね。メイドの鑑だよ。$	$1는 정말 열심히 하네. 메이드의 귀감이야.
$^そうかな？　(.+?)の頑張りを見ていたら、それくらいの言葉、当然のように思えるけど。$	그런가? $1가 열심히 하는 걸 보고 있으면, 그 정도는, 당연하다고 생각하는데.
$^真面目だね、(.+?)は。それじゃ俺はそろそろ行くけど……$	성실하네, $1는. 그럼 난 슬슬 가볼게……
$^(.+?)、そこまで気にしないでいいよ。$	$1, 그렇게까지 신경 안 써도 돼.
$^やっぱり(.+?)は真面目だね。もう少しくらい、肩の力を抜いてもいいのに。$	역시 $1는 성실하네. 좀 더, 어깨의 힘을 빼도 되는데.
$^ん、どうしたの、(.+?)？$	응, 무슨 일이야, $1?
$^そうなんだ。偉いね、(.+?)。$	그랬구나. 기특하네, $1.
$^頼りにしてるよ。しかし、(.+?)は本当に頑張り屋さんで、素敵なメイドだね。$	의지하고 있어. 그나저나, $1는 정말 노력파에 멋진 메이드네.
$^それにしても(.+?)、ずいぶんと上機嫌だけど、どうしたの？$	그건 그렇고 $1, 꽤나 기분이 좋은데 무슨 일 있어?
$^いや、恥ずかしくなんてないと思うよ。楽しそうだったし、なにより(.+?)、可愛いしさ。$	아니, 부끄럽지 않았다고 생각해. 즐거워 보였고, 무엇보다 $1, 사랑스럽고 말야.
$^違う違う、それは誤解だよ。(.+?)が楽しそうに仕事してるから、良かったって思ったんだ。$	아니 아니, 그건 오해야. $1가 즐겁게 일하고 있으니까, 다행이라고 생각했어.
$^(.+?)は、観葉植物が好きなの？$	$1는 식물을 좋아해?
$^それじゃあ(.+?)のおすすめの観葉植物、楽しみにしてるね。$	그럼 $1가 추천하는 화분, 기대하고 있을게.
$^ん、なに、(.+?)。そんな不安そうにして……$	응, 뭐야, $1. 그렇게 불안하게 해서……
$^え？　なに言ってるんだよ、(.+?)。大丈夫、すごくいい感じだよ。$	에? 무슨 말 하는 거야, $1. 괜찮아, 엄청 좋은 느낌이야.
$^ああ、もちろんだよ。(.+?)の好きなように、素敵なデザインにしてほしい。$	아아, 물론이야. $1가 좋아하는대로, 멋진 디자인으로 해 줬으면 좋겠어.
$^……そうか。この仕事をさせる事で、(.+?)を不安にさせてたんだね。$	…… 그런가. 이 일을 시켜서 $1를 불안하게 만들고 있었던 거네.
$^いや、黙っていられるより、はっきり聞いてくれた方が嬉しい。……それで、(.+?)にセンスがあるかどうかって話だけど……$	아니, 가만히 있는 것보다는 분명히 물어 주는 게 좋아. ……그래서, $1에게 센스가 있는지 없는지 하는 이야기인데……
$^そう？　それなら言うけど……(.+?)のセンスは、問題ないよ。$	그래? 그럼 말하는데……$1의 센스는 문제 없어.
$^別に遣ってない、本当の事言ってるだけだよ。(.+?)はセンスあるよ。$	딱히 하고 있지 않아, 사실을 말하고 있을 뿐이야. $1는 센스 있어.
$^だからこれからも、(.+?)にこの仕事を任せていいかな？$	그니까 앞으로도, $1에게 이 일을 맡겨도 될까?
$^やっぱり(.+?)は笑顔の方がいいな。さっきみたいな曇り顔よりさ。$	역시 $1의 웃는 얼굴이 좋은데. 방금 전 같은 흐린 얼굴보다 말야.
$^それなら良かったよ。(.+?)が笑顔だと俺も嬉しいからさ。$	그럼 다행이야. $1가 웃는 얼굴이면 나도 기쁘니까 말야.
$^うん、ありがとう。……ふふ、なんだか(.+?)がお嫁さんみたいだな。$	응, 고마워. …… 후후, 뭔가 $1가 아내같네.
$^おお、(.+?)が俄然やる気になっている……$	오오, $1가 갑자기 의욕이 생기고 있어……
$^どうしたの、(.+?)。$	왜, $1.
$^……(.+?)の真面目さがまた、罪悪感を煽り立てるな、これは。$	……$1의 성실함이 또, 죄악감을 부추기는구나, 이건.
$^それはまあね。でも、きっと(.+?)ならできるから、心配しなくていいと思うよ。$	그건 뭐 그래. 그치만, 분명 $1라면 할 수 있으니까, 걱정 안 해도 된다고 생각해.
$^(.+?)、様になってきたね。なんだか雰囲気合ってるよ。$	$1, 그럴싸한데. 왠지 분위기가 어울려.
$^(.+?)みたいなメイドに接客されたら、お客様もきっと嬉しいだろうと思うよ。$	$1같은 메이드에게 접객 받으면, 손님도 분명 기뻐할 거라고 생각해.
$^なんというか、佇まい？　こう、正面に(.+?)がいて話してると楽しいし、お酒も進む感じかな。$	뭐랄까, 분위기? 이렇게, 정면에 $1가 있어서 이야기하고 있으면 즐겁고, 술도 잘받는 느낌이려나.
$^そんな事ないって。(.+?)の努力に成果なんだから、誇っていいものだと思うよ。$	그렇지 않다니까. $1가 노력한 성과인 거니까, 자랑스러워 해도 좋다고 생각해.
$^……なんだか、(.+?)が妙に色っぽい感じがするな。$	…… 왠지, $1가 묘하게 요염하다는 느낌이 드네.
$^ははは、別に、赤くはなっていないけどさ。いやぁ、(.+?)こそ、結構酔ってるみたいだね？$	하하하, 별로, 얼굴이 빨갛진 않은데 말야. 아니, $1야말로, 꽤나 취한 것 같다?
$^そうだね……。いつもの(.+?)よりも色っぽいというか、艶っぽいというか……なんだかそんな感じだよ。$	그렇네……. 평소의 $1보다 요염하다고 할까, 색기있다고 할까…… 왠지 그런 느낌이야.
$^誰と一緒に飲んでるか？　まあ、お客様は(.+?)と飲んでるわけだから、きっと楽しいだろうと思うよ。$	누구랑 같이 마시는지? 뭐, 손님은 $1랑 마시고 있는 거니까, 분명 즐거울 거라고 생각한다.
$^練習とはいえ、俺も(.+?)と飲めて楽しいよ。……それになんだかドキドキするし。$	연습이라고는 해도, 나도 $1랑 마셔서 즐거워. …… 그리고 왠지 두근두근하고.
$^そりゃそうだよ。……それに、(.+?)。そろそろ飲むのはやめた方がいいんじゃないか？$	그건 그래. …… 그리고, $1. 슬슬 마시는 건 그만두는 게 좋지 않을까?
$^(.+?)は優しいなぁ。良いメイドだよ。$	$1는 상냥한데. 좋은 메이드야.
$^そうだね。(.+?)は、大人の女性に憧れているの？$	그렇네. $1는, 어른스러운 여자를 동경하고 있어?
$^しっかりしてるんだね、(.+?)は。お客様もきっと満足してくれるよ。$	착실하게 하고 있는 거네, $1는. 손님도 분명 만족해 줄 거야.
$^いやいや、そんな事ないって。だって俺、今楽しいからさ、(.+?)と飲んでて。$	아니 아니, 그렇지 않다니까. 왜냐면 나, 지금 즐거우니까, $1랑 마시고 있어서.
$^ああ、当然だよ。だからきっと、これから(.+?)が相手するお客様も、喜んでくれると思うんだ。$	아아, 당연하지. 그니까 분명, 이제부터 $1가 상대하는 손님들도, 기뻐해 줄 거라고 생각해.
$^持っていいと思うよ。(.+?)は充分に頑張ってると思うからさ。$	가지고 있어도 좋아. $1는 충분히 노력하고 있다고 생각하니까 말야.
$^酔った(.+?)も可愛いなぁ……$	취한 $1도 사랑스럽네……
$^そっか。でもそれは(.+?)のおかげだと思うな。$	그래. 그치만 그건 $1 덕분이라고 생각되는 걸.
$^そういうのはよくないよ、(.+?)。$	그러한 것은 좋지 않아, $1.
$^(.+?)なら大丈夫だよ。$	$1라면 괜찮아.
$^かわいいな、(.+?)は。$	귀엽네, $1는.
$^俺も(.+?)から先輩って呼ばれたいなぁ。$	나도 $1가 선배라고 불러줬으면.
$^礼儀正しくて真面目な(.+?)は、後輩ってイメージがあるんだよな。$	예의 바르고 성실한 $1는, 후배라는 이미지가 있구나.
$^だってその格好だと(.+?)がヤケドしちゃうじゃない？$	왜냐하면 그 모습이라면 $1가 화상 해버린다가 아니야?
$^だってその格好だと火も危ないし……料理はいいから、(.+?)とエッチしちゃうのもありかもね。$	왜냐하면 그 모습이라면 불도 위험하고……요리는 좋으니까, $1와 섹스해버린다 것도 있는 곳도.
$^(.+?)は俺の用意した官能小説を目の前で読んでいる。$	$1는 나의 준비한 관능 소설을 눈앞에서 읽고 있다.
$^(.+?)……読み上げてみてよ。$	$1……읽어 내려 봐.
$^可愛いよ(.+?)。勃起してきた。$	사랑스러워 $1. 발기해 왔다.
$^そんな野暮な事を聞かないの。今俺が夢中になっているのは、目の前の(.+?)だけだよ。$	그렇게 촌스러운 일을 (듣)묻지 않는거야. 지금 내가 열중하고 있는 것은, 눈앞의 $1뿐이야.
$^……(.+?)も興奮しちゃってるの？$	…… $1도 흥분해 버린다의?
$^素晴らしいよ、(.+?)……大和撫子な\1がそんなエッチな格好で活花だなんて。$	훌륭해, $1……구식 일본여성인 $1가 그렇게 음란한 모습으로 활화이라니.
$^実に変態的な光景だね、ああ、女体盛りもいつかは(.+?)でやってみたいな。$	실로 변태적인 광경이구나, 아, 여체 번화가도 언젠가는 $1로 해 보고 싶은.
$^興奮してきたな、(.+?)のおまんこで、ワカメ酒かぁ。$	흥분해 오고 싶은, $1의 보지로, 미역술인가.
$^そ、それはちょっと恥ずかしいから、勘弁してほしいかな、(.+?)……$	, 그건 좀 부끄럽기 때문에, 용서 해 주었으면 할까, $1……
$^じゃあ、仕返しに俺も(.+?)の身体にしちゃうけど。ふふ、首筋だけじゃなくて、すっごく恥ずかしいところにキスマークつけたっていいんだよ。$	자, 보복에 나도 $1의 신체로 해버린다지만. 후후, 목덜미만이 아니고, 대단히 부끄러운 곳에 키스 마크 붙여도 좋아.
$^(.+?)なら、構わないよ……$	$1라면, 상관없어……
$^つまらないなぁ、恥らってよ(.+?)。$	재미없구나, 수치등은 $1.
$^ねぇ、エステ子ちゃん。(.+?)にエッチな事しちゃっていいよ？$	응, 에스테틱자. $1에 음란한 일 해 버려서 좋아?
$^えー、(.+?)が女の子にお尻をモミモミされちゃうところ見たいなぁ。$	네―, $1가 여자 아이에게 엉덩이를 만지작만지작 되려는 참 보고 싶다.
$^ちょうどいいね。あぁ、でも(.+?)と一緒に入ったら、興奮してそのまま夜伽になっちゃうかな？$	딱 좋다. 아, 그렇지만 $1와 함께 들어가면(자), 흥분해 그대로 밤시중이 되어 버릴까?
$^俺は(.+?)にそっと耳打ちして、エッチな単語を教える。$	나는 $1에 살그머니 귀엣말해, 음란한 단어를 가르친다.
$^ごめんごめん。でも本当に、可愛いよ(.+?)。$	미안 미안. 그렇지만 정말로, 사랑스러워 $1.
$^……どうしたの、(.+?)？$	……왜, $1?
$^チラチラと周りを気にする(.+?)。$	힐끔힐끔와 주위를 신경쓰는 $1.
$^本来なら接客の練習の時にはお客様がいないけど……俺は(.+?)を恥ずかしがらせる為に複数人お客様を呼んでいたのだった。$	본래라면 접객의 연습때에는 손님이 없지만……나는 $1를 부끄러워하게 하기 위해 복수인 손님을 부르고 있었던 것이었다.
$^俺以外の男に見られて照れる(.+?)は可愛いよ。$	나 이외의 남자로 보여져 수줍은 $1는 사랑스러워.
$^はは、ごめんね。でも恥ずかしがる(.+?)を見てるせいかな、美味しいよ。$	(은)는은, 미안해요. 그렇지만 부끄러워하는 $1를 보는 탓인지, 맛있어.
$^言いながらお酒を勧めてくる(.+?)。$	말하면서 술을 권해 오는 $1.
$^もしかして(.+?)……俺を酔い潰そうとしてる？$	혹시 $1……나를 취기궤 그렇다고 하고 있어?
$^(.+?)、何をしてるの？$	$1, 무엇을 해?
$^(.+?)が裁縫してるの、あんまり見たことないなぁ。$	$1가 재봉 해, 별로 본 적 없다.
$^そうだね、(.+?)の頑張りがどれくらいか知りたいし。$	그렇다, $1의 분발함이 어느 정도인가 알고 싶고.
$^(.+?)、裁縫にも慣れてきた？$	$1, 재봉에도 익숙해져 왔어?
$^でも、何でもやってみようっていう(.+?)の前向きな姿勢はいいと思う。$	그렇지만, 뭐든지 해 보자고 하는 $1의 적극적인 자세는 좋다고 생각한다.
$^(.+?)が裁縫もできるようになったら、もう完璧超人だね。$	$1를 재봉도 할 수 있게 되면(자), 이제(벌써) 완벽 초인이구나.
$^いやあ、(.+?)は頑張り屋さんだなって思って。$	야, $1는 노력해 가게라고 생각해.
$^ああ、あれ直してくれたの(.+?)だったんだ。ありがとう。$	아, 저것 고쳐 준 것 $1였다. 고마워요.
$^だったら、単に俺が(.+?)と一緒に行きたいだけなんだよ、って言ったら？$	그렇다면, 단지 내가 $1와 함께 가고 싶은 것뿐이야, 라고 말하면(자)?
$^ど、どうしたの、(.+?)。$	무, 무슨일이야, $1.
$^バカ、(.+?)は俺の恋人だろ。恋人が怪我をしたら心配するに決まってるじゃないか。$	바보, $1는 나의 연인이겠지. 연인가 다치면(자) 걱정하는에 정해져있는이 아닌가.
$^(.+?)の血なら吸い出して全部飲んじゃいたいくらいだ。$	$1의 피라면 빨아내 전부 마셔버릴 싶을 정도 다.
$^いいね、吸血鬼。(.+?)を俺のしもべにできるし。$	좋다, 흡혈귀. $1를 나의 머슴이 할 수 있고.
$^やあ、(.+?)。調子はどう？$	야, $1. 상태는 어때?
$^(.+?)は勉強家だね。何でもすぐに上達するんだからすごいよ。$	$1는 공부가구나. 뭐든지 곧바로 능숙해지기 때문에 대단히.
$^じゃあ、俺が(.+?)のことをもっともっと好きになれば……$	자, 내가 $1를 좀더 좀더 좋아하게 되면……
$^(.+?)はいつも頑張り過ぎちゃうから。時にはリラックスして欲しいし。$	$1는 너무 언제나 노력해버리니까. 때로는 릴렉스해 주었으면 하고.
$^あれ、(.+?)。何をしてるの？$	저것, $1. 무엇을 해?
$^縫い付けてるのって(.+?)の名前？$	꿰매어라고 $1의 이름?
$^ダメじゃないけど……そんなことしなくたって、俺は(.+?)のことを忘れたりしないよ。$	안되지 않지만……그런 금년 없어도, 나는 $1를 잊거나 하지 않아.
$^やあ、(.+?)。$	야, $1.
$^(.+?)が料理するとこ、見てちゃダメかな。$	$1가 요리하는 곳, 견안된가.
$^そんなことないよ。(.+?)は料理得意？$	그렇지 않아. $1는 요리 이익?
$^随分と手がかかってそうだ。頑張ってくれたんだね。ありがとう、(.+?)。$	상당히 손이 많이 가 그렇다. 노력해 주었군요. 고마워요, $1.
$^料理を作ってるんだね、(.+?)。$	요리를 만들고 있어, $1.
$^今日は(.+?)の料理が食べられるんだ。楽しみだなぁ。$	오늘은 $1의 요리를 먹을 수 있다. 기다려지는구나.
$^おっ、料理してるね、(.+?)。いい匂いだ。$	, 요리하고 있구나, $1. 좋은 냄새다.
$^おいしいと思うよ。それに(.+?)に作ってもらえたら、それだけで嬉しいしね。$	맛있다고 생각해. 거기에 $1에 만들어 줄 수 있으면(자), 그 만큼으로 기쁘기도 하고.
$^男は女性の手料理に弱いんだ。(.+?)は最高の調味料だってこと。$	남자는 여성의 손요리에 약하다. $1는 최고의 조미료도 일.
$^今日も頑張ってるね、(.+?)。$	오늘도 노력하고 있구나, $1.
$^ははは、気にしすぎだよ。別に料理がヘタでも(.+?)が好きだってことに変わりはないから。$	하하하, 너무 신경써. 별로 요리가 열매 꼭지에서도 $1를 좋아한다고 일로 변화는 없으니까.
$^も、もちろんだよ。(.+?)だけが俺の恋人だから。$	도, 물론이야. $1만이 나의 연인이니까.
$^大丈夫だから！　(.+?)が一番だから！$	괜찮기 때문에! $1가 제일이니까!
$^やあ、(.+?)。何をしてるの？$	야, $1. 무엇을 해?
$^ふうん、(.+?)は勉強家なんだね。$	식응, $1는 공부가야.
$^やあ、(.+?)。随分と分厚い本を読んでるね。重くないの？$	야, $1. 상당히 두꺼운 책을 읽고 있구나. 무겁지 않은거야?
$^ちょっと、(.+?)。$	좀, $1.
$^(.+?)は漫画読まないの？$	$1는 만화 읽지 않는거야?
$^いやあ、(.+?)は本当に勉強家だよね。すごく熱心に見てたでしょ。$	야, $1는 정말로 공부가지요. 몹시 열심히 보고 있었던이겠지.
$^ど、どうしたの！？　(.+?)、なんで泣いてるの！？$	무, 무슨일이야!? $1, 어째서 울어!
$^いやいや、俺と(.+?)は結ばれることが許されない関係じゃないでしょ。$	아니아니, 나와 $1는 연결되는 것이 허락되지 않는 관계가 아니지요.
$^そんなことないって。俺はみんなに(.+?)が恋人だって言ってるよ。$	그렇지 않다고. 나는 모두에게 $1가 연인라고 말하고 있어.
$^わかったわかった。じゃあ俺は(.+?)より長く生きるから。それなら大丈夫だろ？$	안 알았다. 자나는 $1보다 길게 살기 때문에. 그렇다면 괜찮겠지?
$^あれ、(.+?)。今日は何を読んでるの？$	저것, $1. 오늘은 무엇을 읽어?
$^あ、(.+?)がエッチな本を読んでる。$	아, $1가 음란한 책을 읽고 있다.
$^バカだなぁ、別にうまくなくたって(.+?)を飽きたりしないよ。$	바보구나, 별로 능숙하지 않아도 $1를 만족하고 하지 않아.
$^今でも十分(.+?)に夢中だってば。それにこういう勉強は二人でやった方が捗るよ。$	지금도 충분히 $1에 열중하다니까. 거기에 이런 공부는 둘이서 한 (분)편이 진전되어.
$^花を生けてるんだね、(.+?)。$	꽃을 심고 있어, $1.
$^(.+?)は優しいんだね。$	$1는 상냥하다.
$^は、ははは……何か(.+?)がだんだん怖くなってきたな。$	(은)는, 하하하……무엇인가 $1가 점점 무서워졌군.
$^おお、何だか堂に入ってるね、(.+?)。$	, 무엇인가 원숙해지고 있구나, $1.
$^いや、(.+?)がものすごく頑張ってるってことは伝わってきたよ。$	아니, $1가 대단히 노력하고 있다고 (일)것은 전해져 왔어.
$^(.+?)、あんまり根を詰めてやらなくてもいいんだよ。$	$1, 별로 뿌리를 채워 주지 않아도 괜찮아.
$^(.+?)に華道をやってもらってるのは、あくまでも女性らしさを磨いて欲しいからなんだ。$	$1에 화도를 해 주고 있는 것은, 어디까지나 여성다움을 닦았으면 좋기 때문에야.
$^いや、いいんだよ。そういう真面目なところが、(.+?)の最大の魅力だからね。$	아니, 좋아. 그러한 성실한 곳이, $1의 최대의 매력이니까.
$^調子はどうかな、(.+?)。$	상태는 어떨까, $1.
$^もちろんだよ。(.+?)の頑張りをみんなに見てもらいたいからね。$	물론이야. $1의 분발함을 모두에게 보이고 싶으니까.
$^それが(.+?)の個性なんだと思うよ。別にいいんじゃないか？$	그것이 $1의 개성이야라고 생각해. 별로 좋지 않을까?
$^今日は何をしているの、(.+?)。$	오늘은 무엇을 하고 있는 것, $1.
$^大丈夫、(.+?)だったら綺麗なのが作れると思うよ。$	괜찮아, $1라면 깨끗한 것이 만들 수 있다고 생각해.
$^そんなの、もちろん(.+?)だよ。$	그런 것, 물론 $1야.
$^大丈夫、俺の心は(.+?)にしか向いてないよ。$	괜찮아, 나의 마음은 $1밖에 향하지 않았어.
$^ううん、これといってないかな。綺麗だったら何でも好きだよ。(.+?)は？$	으응, 이렇다 하지 않을까. 깨끗하면 뭐든지 좋아해. $1는?
$^じゃあ(.+?)の誕生日には、赤いチューリップとワスレナグサを毎年送るよ。$	자 $1의 생일에는, 붉은 튤립과 물망초를 매년 보내.
$^(.+?)、化粧してるんだ。$	$1, 화장하고 있어.
$^多分、(.+?)に合わないメイクをしてるからだと思う。$	아마, $1에 맞지 않는 메이크를 하고 있으니라고 생각한다.
$^(.+?)は元がかわいいんだから、あんまり濃い化粧はいらないと思うよ。$	$1는 원이 귀엽기 때문에, 너무 진한 화장은 필요없다고 생각해.
$^人にも寄るけど、(.+?)はもっと素朴な方がかわいいと思うんだ。$	사람에게도 모이지만, $1는 좀 더 소박한 (분)편이 귀엽다고 생각한다.
$^あれ、(.+?)だよね？$	저것, $1지요?
$^(.+?)の顔を見るのが楽しみになってきたな。$	$1의 얼굴을 보는 것이 기다려지게 되었군.
$^ああ、(.+?)の化粧はかわいいというより綺麗って感じだな。$	아, $1의 화장은 귀엽다고 하는 것보다 깨끗하다는 것은 느낌이다.
$^(.+?)はどんな化粧をしてても魅力的ってことだよ。$	$1는 어떤 화장을 해도 매력적은 것이야.
$^やあ、(.+?)。何をやってるの？$	야, $1. 무엇을 해?
$^ははは、メイクもいいけど、(.+?)は一番大事なことを忘れてるよ。$	하하하, 메이크도 좋지만, $1는 제일 소중한 일을 잊고 있어.
$^ほら、(.+?)は笑うとこんなにかわいいんだから。$	이봐요, $1는 웃는 곳 무엇인가원 좋기 때문에.
$^(.+?)にとって、化粧なんておまけだね。$	$1에 있어, 화장은 덤이구나.
$^(.+?)が楽しそうなところが見られて嬉しいよ。それに、今日はいつもと雰囲気がちょっと違うね。$	$1가 즐거운 듯 하는 곳이 볼 수 있어 기뻐. 게다가, 오늘은 평상시와 분위기가 조금 다르군요.
$^わかってて言ったの？　(.+?)も人が悪いなぁ。$	알고 있어 말했어? $1도 성질이 나쁘다.
$^それもいいけど、(.+?)は何をつけても似合うし、俺は色々な\1が見たいかな。$	그것도 좋지만, $1는 무엇을 붙여도 어울리고, 나는 다양한 $1를 보고 싶을까.
$^あれ、(.+?)。化粧してるんだ。$	저것, $1. 화장하고 있어.
$^そんなことしなくても、俺は(.+?)のことしか眼中にないよ。$	그런 일 하지 않아도, 나는 $1밖에 안중에 없어.
$^たまによそ見くらいはするけど、俺だって好きなのは(.+?)だけだよ。$	이따금 곁눈질 정도는 하지만, 나라도 좋아하는 것은 $1뿐이야.
$^ああ、(.+?)か。どうかしたの？$	아, $1인가. 어떻게든 했어?
$^そうだなぁ、俺は薄くてもいいと思うよ。(.+?)は素材がいいからね。$	그렇다, 나는 얇아도 괜찮다고 생각해. $1는 소재가 좋으니까.
$^でも、(.+?)だったらきっちりメイクでも綺麗に見えると思う。どっちでもいいかな。$	그렇지만, $1라면 빈틈없이 메이크에서도 깨끗이 보인다고 생각한다. 어느 쪽이라도 좋을까.
$^違うよ、どんな化粧をしてたって、(.+?)は俺が大好きな\1だってこと。$	달라, 어떤 화장을 하고 있었던은, $1는 나를 아주 좋아하는 $1도 일.
$^……おお、綺麗だね、(.+?)。$	……, 깨끗하다, $1.
$^完璧だと思う。綺麗すぎて、思わず(.+?)の唇に吸い付きたくなっちゃったよ。$	완벽하다고 생각한다. 너무 깨끗해, 무심코 $1의 입술에 달라붙고 싶어져 버렸다.
$^(.+?)、エステのマッサージはどう？$	$1, 에스테틱의 맛사지는 어때?
$^いいんだよ。(.+?)がもっと綺麗になってくれたら俺も嬉しいからね。$	좋아. $1가 좀 더 깨끗이 되어 주면(자) 나도 기쁘니까.
$^んー、(.+?)はもともと綺麗だからなぁ。$	응―, $1는 원래 깨끗하기 때문에.
$^うんうん、恥ずかしがってる(.+?)もかわいいよ。$	응응, 부끄러워하고 있는 $1도 귀여워.
$^ごめん、だって(.+?)がすごく気持ちよさそうな顔してるからさ。$	미안, 이래 $1가 몹시 기분이야 유혹한데 얼굴 하고 있으니.
$^(.+?)、ちょっと触ってみていい？$	$1, 조금 손대어 봐도 좋아?
$^気持ちよさそうだね、(.+?)。$	기분이야 유혹하는이구나, $1.
$^ははは、(.+?)がそこまで蕩けきった顔をするの、珍しいよね。$	하하하, $1가 거기까지 녹고 자른 얼굴을 하는 것, 드물지요.
$^やあ、(.+?)。エステの感想は？$	야, $1. 에스테틱의 감상은?
$^笑ってるし……(.+?)って触られるの苦手だっけか。$	웃고 있고…… $1는 손대어지는 것 서투르던가인가.
$^はは、(.+?)が気持ちよさそうだ。$	(은)는은, $1가 기분이야 유혹하는이다.
$^なら(.+?)は安心だな。俺はいつでも\1が綺麗だと思ってるよ。$	(이)라면 $1는 안심이다. 나는 언제라도 $1가 깨끗하다고 생각하고 있어.
$^(.+?)、リラックスしてるみたいだね。$	$1, 릴렉스 하고 있는 것 같다.
$^……本当に気持ちよさそうだね、(.+?)。$	……정말로 기분이야 유혹하는이구나, $1.
$^あ、あのさ、(.+?)。ひょっとして感じたりしてない？$	아, 그런데 말이야, $1. 혹시 느끼거나 하지 않아?
$^いや、(.+?)があまりに色っぽい声を出すからさ……$	아니, $1가 너무나 요염한 소리를 내기 때문에 ……
$^やあ、(.+?)。掃除してるんだ。$	야, $1. 청소하고 있어.
$^(.+?)って、実は掃除好き？$	$1는, 실은 청소를 좋아하는 사람?
$^(.+?)に掃除を任せたら、塵一つ落ちてないってくらい綺麗になりそうだなぁ。$	$1에 청소를 맡기면(자), 진1개(살) 떨어지지 않다고 정도 깨끗이 될 것 같다.
$^うわ、ピッカピカだ……(.+?)はすごいよ。徹底してるね。$	위, 픽커 피카(아시아 민간 투자 회사)다…… $1는 대단히. 철저히 하고 있구나.
$^頑張ってるね、(.+?)。今日は何してるの？$	노력하고 있구나, $1. 오늘은 어떻게 해?
$^精が出るね、(.+?)。$	힘쓰는군, $1.
$^(.+?)は掃除が好きなんだね。$	$1는 청소를 좋아하구나.
$^でも、(.+?)の部屋はいつ見ても片付いてて綺麗だよね。$	그렇지만, $1의 방은 언제 봐도 정리되고 있어 깨끗하지.
$^ううん、(.+?)に任せたら大事なものまで捨てられちゃいそうだし。$	으응, $1에 맡기면(자) 소중한 것까지 버려져버릴 것 같고.
$^あれ、そうだったの？　てっきり(.+?)の匂いかと思った。$	저것, 그랬어?　틀림없이 $1의 냄새일까하고 생각했다.
$^でもほら、(.+?)からもいい匂いがするし。$	그렇지만 이봐요, $1로부터도 좋은 냄새가 나고.
$^(.+?)の匂いって、なんか少し興奮するよね。$	$1의 냄새는, 어쩐지 조금 흥분하지요.
$^掃除してるんだ、(.+?)。$	청소하고 있어, $1.
$^(.+?)の様子を見に来たんだ。調子はどう？$	$1의 상태를 보러 왔다. 상태는 어때?
$^心配しなくても俺はいつでも(.+?)のものだよ。$	걱정하지 않아도 나는 언제라도 $1의 것이야.
$^ああ、そういうことか。(.+?)はエッチだなぁ。$	아, 그런 것인가. $1는 음란하다.
$^精が出るね、(.+?)。すごく綺麗になってるよ。$	힘쓰는군, $1. 몹시 깨끗이 되어 있어.
$^(.+?)の掃除？　それって……$	$1의 청소?　그 거……
$^あれ、(.+?)。何だか難しそうな顔をしてるね。どうしたの？$	저것, $1. 왠지 어려울 것 같은 얼굴을 하고 있구나. 왜?
$^(.+?)は、こういう部屋が好きっていうのは何かない？$	$1는, 이런 방을 좋아한다고 말하는 것은 무엇이지 있고?
$^そうすれば(.+?)らしいコーディネートになるし、素敵じゃないかな。$	그러면 $1인것 같은 코디네이터가 되고, 멋진 것이 아닐까.
$^何か悩んでるのかな、(.+?)。$	무엇인가 고민하고 있을까, $1.
$^(.+?)はどうしたいの？$	$1는 어떻게 하고 싶은거야?
$^だったらやってみなよ。模様替えを任されてるのは(.+?)なんだからさ。$	그렇다면 해 봐. 재배치를 맡고 있는 것은 $1니까.
$^この部屋、いい感じだね。(.+?)が模様替えしてくれたの？$	이 방, 좋은 느낌이구나. $1가 재배치해 주었어?
$^よし、それじゃ俺の部屋も(.+?)にコーディネートしてもらおうかな。$	좋아, 그러면 나의 방도 $1에 코디네이터 받을까.
$^(.+?)、どうしたの。困った顔して。$	$1, 왜. 곤란한 얼굴 해.
$^もちろん、(.+?)だってここのメイドなんだからね。自信を持っていいよ。$	물론, $1도 여기의 메이드니까. 자신을 가지고 있어라.
$^(.+?)の好きなようにやって構わないからね。$	$1가 좋아하는 것 같게 해 상관없으니까.
$^やあ、(.+?)。今日は何をしてるの？$	야, $1. 오늘은 무엇을 해?
$^そっか、(.+?)には色々と任せてるもんね。言ってみてよ。$	그래, $1에는 다양하게 맡기고 있는 것이군요. 말해 봐.
$^ありがとね、(.+?)。$	고마워, $1.
$^(.+?)がやってくれたんだ。何か明るくなったよね。$	$1가 해 주었다. 무엇인가 밝아졌지.
$^ああ、(.+?)。どうしたの？$	아, $1. 왜?
$^それじゃよろしくね、(.+?)。$	그러면 잘 부탁해, $1.
$^いや、びっくりしたよ。(.+?)は本当に勉強家だね。$	아니, 놀랐어. $1는 정말로 공부가구나.
$^もちろん。(.+?)が一緒だったらいいお酒が飲めそうだ。$	물론. $1가 함께라면 좋은 술을 마실 수 있을 것 같다.
$^大丈夫、(.+?)ならきっと最高のメイドになれるよ。$	괜찮아, $1라면 반드시 최고의 메이드가 될 수 있어.
$^どうかな、(.+?)。そろそろ接客は慣れてきた？$	어떨까, $1. 슬슬 접객은 익숙해져 왔어?
$^大丈夫、酔ってる(.+?)もかわいいから。それで十分だよ。$	괜찮아, 취하고 있는 $1도 귀여우니까. 그래서 충분해.
$^そりゃもう、(.+?)といっぱい愛し合いたい。$	그렇다면 이제(벌써), $1와 가득 서로 사랑하고 싶다.
$^う、ううん、(.+?)だけかはわからないけど……$	, 으응, $1만일 수 있는인가는 모르는데……
$^さあ、(.+?)。今日は接客の練習だよ。$	자, $1. 오늘은 접객의 연습이야.
$^ははは、まあ(.+?)ならそう言うと思ったよ。でも仕事だからね。$	하하하, 뭐 $1말하자 말한다고 생각했어. 그렇지만 일이니까.
$^わかった、頑張ってくれたらご褒美をあげる。(.+?)が望むものを用意するよ。$	안, 노력해 주면(자) 포상을 준다. $1가 바라는 것을 준비할게.
$^甘えん坊だなぁ、(.+?)は。$	응석꾸러기구나, $1는.
$^(.+?)もだいぶお酒の進め方がうまくなったね。お陰で酔っぱらっちゃったよ。$	$1도 많이 술의 진행방식이 잘 되었군요. 덕분으로 술취해 버렸다.
$^１０分くらい前かなぁ……(.+?)、集中してたから話しかけづらくて……。$	10분 정도 전일까…… $1, 집중하고 있었기 때문에 말을 건네기 힘들어서…….
$^うぉぉ……これは気持ちいい。流石(.+?)、的確なアドバイスだね。$	……이것은 기분이 좋다. 유석 $1, 적확한 어드바이스구나.
$^(.+?)、かなり詳しいんだね。$	$1, 꽤 자세하다.
$^ずぷっ……？　あ、ちょっと黙らないで、怖いから……(.+?)……？　おーい、\1？$	……?　아, 조금 입다물지 말고, 무섭기 때문에…… $1……?　어이, $1?
$^凄く気持ちいいんだけど、(.+?)的には不満なの？$	굉장히 기분이 좋지만, $1적이게는 불만이야?
$^(.+?)は思いのほか、厳しいな。$	$1는 생각외, 어려운데.
$^ははっ、(.+?)は独占欲が強いなぁ。$	(은)는 하, $1는 독점욕이 강하다.
$^まぁ、(.+?)に教えたメイドは……顔真っ赤にして恥ずかしがってるけどね。$	아무튼, $1에 가르친 메이드는……얼굴 새빨갛게 해 부끄러워하고 있지만.
$^恥ずかしい格好の(.+?)の指をぺろぺろしてあげる……$	부끄러운 모습의$1의 손가락을 날름날름 해 준다……
$^あ、(.+?)っ！　それはダメだ、ちょっと待って、今すぐ料理をやめるんだ。$	아,$1!　그것은 안된다, 조금 기다려, 금방 요리를 그만둔다.
$^(.+?)の綺麗な肌に、ヤケドなんてさせちゃったらご主人様失格だ。ごめん、俺の伝達ミスだった。$	$1의 깨끗한 피부에, 화상은 시켜 버렸다들 주인님 실격이다. 미안, 나의 전달 미스였다.
$^ごめんよ、(.+?)……$	미안,$1……
$^さて、それじゃあその格好で料理する(.+?)の姿を見ようかな。$	그런데, 그러면 아 그 모습으로 요리하는$1의 모습을 볼까.
$^(.+?)は本当に可愛いなぁ……$	$1는 정말로 사랑스럽다……
$^俺は(.+?)の表情を見て、満足するのであった。$	나는$1의 표정을 봐, 만족하는 것에서 만났다.
$^な、なんか……妙にエロいよね、(.+?)。$	, 어쩐지……묘하게 에로 있어라,$1.
$^そんな、俺は芸術っぽさも感じているよ。綺麗だよ(.+?)、可愛いよ\1。$	그런, 나는 예술 같음도 느끼고 있어. 깨끗해$1, 사랑스러워$1.
$^そっか、じゃあ(.+?)が忘れた頃に、お姫様だっこで薔薇のベッドにエスコートするよ。$	그래, 자$1가 잊었을 무렵에, 공주님 안기로 장미의 침대에 에스코트 할게.
$^あはは。まぁ、(.+?)はお化粧なんてしなくっても十分可愛いんだけどね。$	아하하. 아무튼,$1는 화장은 하지 않아서도 충분히 사랑스럽지만.
$^(.+?)……今のはぐっと来たね。$	$1……지금이 벗기는 와 왔군요.
$^いや、これは(.+?)を見たときからずっとだよ。$	아니, 이것은$1를 보았을 때로부터 쭉이야.
$^ともかく、(.+?)の想いが聞けてよかったよ。俺も\1の事を大切に夜伽するから。$	어쨌든,$1의 구상을 (들)물을 수 있어서 좋았어요. 나도$1의 일을 소중히 밤시중 하기 때문에.
$^この時間はエステということで、目の前では(.+?)が自分の体をほぐす手に身をゆだねていた。$	이 시간은 에스테틱이라고 하는 것으로, 눈앞에서는$1가 자신의 몸을 푸는 손에 몸을 맡기고 있었다.
$^背中だって十分にエッチだよ、むしろおっぱいが見えないのが興奮する……(.+?)の背中って綺麗だね。$	등도 충분히 음란해, 오히려 젖가슴이 안보이는 것이 흥분하는……$1의 등은 깨끗하다.
$^(.+?)、今すぐ始めようか。$	$1, 바로 지금 시작할까.
$^(.+?)のお尻は綺麗だなぁ……ふふ……$	$1의 엉덩이는 깨끗하다……후후……
$^(.+?)～、様子を見に来たよ。$	$1~, 상태를 보러 왔어.
$^(.+?)のパンツとか、今はここに無い感じ？　ちょっと見てみたいんだけど。$	$1의 팬츠라든지, 지금은 여기에 없는 느낌?　조금 보고 싶지만.
$^俺の意見だけど、そのパンツをはいている所を想像して興奮する感じかな。これが(.+?)の大切な場所を包んでいるんだって想像して。$	나의 의견이지만, 그 팬츠를 입고 있는 곳을 상상해 흥분하는 느낌일까. 이것이$1의 중요한 장소를 싸고 있다고 상상해.
$^パンツ泥棒はまた違うのかもしれないけど、俺は根本的に(.+?)の事が好きだからパンツも好きって感じ……かな。$	팬츠 도둑은 또 다를지도 모르지만, 나는 근본적으로$1의 일을 좋아하기 때문에 팬츠도 좋아한다는 것은 느낌……일까.
$^うん……(.+?)、パンツ見せてくれる？$	응……$1, 팬츠 보여 줄래?
$^俺は(.+?)の模様替えを手伝っていた。$	나는$1의 재배치를 돕고 있었다.
$^(.+?)に無理をさせられないからねそんな格好してると動きにくいだろ？$	$1에 무리를 시킬 수 없으니까 그런 모습 하고 있다고(면) 움직이기 어려운이겠지?
$^(.+?)が自主的にしているのかと思った。$	$1가 자주적으로 하고 있는지 생각했다.
$^ゴク……その格好で色々運ぶ(.+?)の姿を想像すると、すごく興奮するな……$	고크……그 모습으로 여러가지 옮기는$1의 모습을 상상하면(자), 몹시 흥분하지 말아라……
$^(.+?)は興奮しない？$	$1는 흥분하지 않아?
$^サロンでお漏らししちゃう(.+?)が見たいなぁ。$	살롱으로 흘려버리는$1를 보고 싶다.
$^……本気で頼んだら、(.+?)はしてくれる？$	……진심으로 부탁하면(자),$1젓가락이라고 주어?
$^ふふ、いいよ。もし(.+?)がエッチな気持ちになるんだったら俺命令するけど、いきなり言ったらダメだよね。$	후후, 좋아. 만약$1가 음란한 기분이 되려면 나명령하지만, 갑자기 말하면(자) 안되지.
$^じゃ、夜伽で(.+?)のおしっこ……見せてくれる？$	그러면, 밤시중으로$1의 오줌……보여 줄래?
$^気のせいだよ。(.+?)のおしっこ楽しみだなぁ。$	기분탓이야. $1의 오줌 기다려지는구나.
$^(.+?)、あとでいいんだけどさ、俺の服のボタンつけてくれる？$	$1,나중이라도 좋지만, 내 옷에 버튼을 좀 붙여줄래?
$^裁縫は(.+?)にお任せだね。$	재봉은 $1에게 맡기라는 거구나.
$^しかし手際いいなあ。(.+?)はきっといいお嫁さんになるよ$	하지만 솜씨 좋아. $1는 반드시 좋은 신부가 될 거야.
$^(.+?)は地球にでも何にでも優しいよ$	$1는 지구라도 무엇이라도 상냥해
$^本当に(.+?)は裁縫上手だよね。好きこそものの上手なれって奴かな$	정말로 $1는 재봉에 능숙하네. 좋아한다는 것만으로 능숙하게 될 수 있다는 것일까.
$^(.+?)が一緒なら、どこでも心はあったかいよ$	$1가 함께라면, 어디에서라도 마음은 따뜻해
$^(.+?)はお姉ちゃんなのに甘えん坊だなぁ。そこがまた可愛いよ$	$1는 누나인데 응석꾸러기구나. 거기가 또 사랑스러워.
$^どこまでが冗談なのかわからないけど、(.+?)のセンスを信じてみるよ$	어디까지가 농담인지 모르겠지만, $1의 센스를 믿어 볼게.
$^辛党って言っておこうかな。だって(.+?)ってすごい甘党っぽいから$	애주가라고 말할까. 왜냐하면 $1는 단 걸 엄청 좋아하는 것 같으니까.
$^あ、ああ。(.+?)の舌はわりと信用してるから、まぁいいか……$	아, 아아. $1의 혀는 비교적 신용하고 있으니까, 아무튼 괜찮을까……
$^(.+?)さえ良ければ、今日は外食にしてもいいけど……？$	$1이 좋다면야, 오늘은 외식으로 해도 괜찮지만……?
$^嬉しいよ。でも、料理ができなくても(.+?)の魅力は変わらないからね$	기뻐. 그렇지만, 요리를 할 수 없어도 $1의 매력은 변함없으니까.
$^(.+?)が作ってくれるものならなんでも嬉しいって意味なのに$	$1가 만들어 주는 것이라면 뭐든지 기쁘다는 의미인데.
$^いや、大抵の人は大丈夫だと思うよ。でも、(.+?)らしいとは思う$	아니, 대부분의 사람은 괜찮다고 생각해. 그렇지만, $1답다고 생각해.
$^まさか。結構(.+?)って、勉強熱心なほうでしょ$	설마. 꽤 $1는, 공부 열심인 편이겠지.
$^(.+?)は勉強なんてしなくても、すごくエッチな声出すしね$	$1는 공부는 하지 않아도, 몹시 음란한 소리를 내기도 하고.
$^(.+?)って機械とか苦手そうだしね$	$1는 기계라든지에 서투른 것 같아 보이는군.
$^まだそこまでイメージできないよ……。ええっと、(.+?)は？$	아직 거기까지는 이미지할 수 없어……. 그럼, $1는?
$^(.+?)って子供に懐かれそうなタイプだね$	$1는 아이에게 따라질 것 같은 타입이네.
$^(.+?)は本当に子供が好きなんだね$	$1는 정말로 아이를 좋아하는구나.
$^(.+?)にぴったりな花言葉だよ$	$1에게 딱 맞는 꽃말이야.
$^じゃあ、基本とか伝統にこだわらずに(.+?)のやりたいようにやってみればいいんじゃないかな$	자, 기본이라든지 전통에 집착하지 않고 $1가 하고싶은대로 해보면 되지 않을까.
$^(.+?)はすごく優しいから$	$1는 몹시 상냥하니까.
$^ごめん、(.+?)の綺麗な顔しか見られなくて、花がよく見えなかったよ$	미안, $1의 깨끗한 얼굴밖에 볼 수 없어서, 꽃이 잘 안 보였어.
$^(.+?)、すごく綺麗だ。俺も好きだよ$	$1, 진짜 예쁘다. 나도 좋아해
$^じゃあ、(.+?)みたいに赤いこの花を活け終わったら、俺の私室用に貰おうかな$	자, $1같이 붉은 이 꽃을 꽂고 나면, 내 방에 쓸 수 있게 받도록 할까.
$^そうだよ。(.+?)は笑顔が特に可愛いね$	그래. $1는 웃는 얼굴이 특히 사랑스러워.
$^(.+?)キャリアウーマン風か……イメージ湧かないな$	$1 캐리어 우먼식인가……이미지가 생기질 않는데.
$^そもそも(.+?)はそういうの苦手そうだよね。$	원래 $1는 그런 데 서투른 것 같네.
$^あるような気がする。あ、(.+?)……唐突なんだけど$	있는 것 같은 생각이 드네. 아, $1……당돌한데.
$^(.+?)、化粧って楽しい？$	$1, 화장은 즐거워?
$^ねぇ(.+?)、ちょっと化粧のことで尋ねたいんだけど$	응 $1, 조금 화장하는 것에 대해 묻고 싶지만
$^これからも(.+?)のエッチな顔、いろいろ見たいよ$	앞으로도 $1의 음란한 얼굴, 여러가지 보고 싶어.
$^ごめんごめん。恥ずかしがってる(.+?)ってすごく可愛いから、ついね$	미안 미안. 부끄러워하고 있는 $1는 몹시 사랑스러우니까, 무심코.
$^ありがとう、俺にも(.+?)が可愛いよ$	고마워, 나에게도 $1가 사랑스러워.
$^道行く人も(.+?)のことが可愛いって思ってるよ。誰にも渡さないけどね$	길 가는 사람이 $1가 사랑스럽다고 생각하고 있어. 누구에게도 건네주지 않을 거지만.
$^ルージュ引いてるとき、(.+?)っていつも機嫌いいよね$	루즈를 바르고 있다면. $1는 언제나 기분이 좋지.
$^なんだ、冗談か。ふう、急に(.+?)が嫉妬深くなったのかと$	뭐야, 농담인가. 훗, 갑자기 $1가 질투심이 불타오르는 건가.
$^それは大丈夫。俺の心はもう(.+?)だけのものだよ$	그건 괜찮아. 나의 마음은 이미 $1만의 것이야.
$^フフフ、何を満足しているんだい、(.+?)。まだまだエステは始まったばかりだよ？　ウォーミングアップはここまでだ！　まずは……内臓の調子を整えるマッサージッ！$	후후후, 무엇을 만족한거야, $1. 아직도 에스테틱은 시작하고서 바로 직후야? 워밍업은 여기까지다! 우선은……내장의 상태를 정돈하는 마사지!
$^全身の肌を刺激し、汗と共に体外に排出された不純物をアロマオイルと一緒に拭い取る秘技！　これで(.+?)のお肌はむきたてつるつるゆで卵のようだ！$	전신의 피부를 자극해, 땀과 함께 체외에 배출된 불순물을 향기 오일과 함께 닦아 취하는 비장의 기술! 이것으로 $1의 피부는 껍질을 벗긴 반들반들한 삶은 달걀과 같아!
$^甘い、甘いぞ(.+?)！　真のエステとは、肉体の美しさを求めるものにあらず！　外的な美しさは不随したものにすぎない！$	다, 달아 $1! 진정한 에스테틱이란, 육체의 아름다움을 요구하는 것에 있지 않지! 외적인 아름다움은 부차적인 것에 지나지 않아!
$^……ふふ、効いてきたようだな。そう、乱撫安息掌とはそのとおり、対象をリラックスさせる技なのだ！　なんて、技名は今、適当に決めたんだけど……あれ？　(.+?)？$	……후후, 효과가 있는 것 같네. 그래, 난무안식장은 바로, 대상을 릴렉스 시키는 기술이다! 뭐, 기술명은 지금, 적당하게 결정했지만……어? $1?
$^むむぅ。どうしよう……そうだ！　なあ、(.+?)。$	이런, 어떻게 하지……그렇지! 자, $1.
$^どんどん綺麗になっていく(.+?)を見ていたら、そりゃ興奮もするさ。$	자꾸자꾸 깨끗이 되어가는 $1를 보고 있으니까, 그렇다면 흥분도 하고 말이야.
$^(.+?)、何を言ってるの？$	$1, 무슨 말을 하는거야?
$^いやいや、変なのは(.+?)のほうだから！　エステって、そもそも交互にするようなものじゃないでしょう？$	아니아니, 이상한 것은 $1쪽이니까! 에스테틱은, 원래 교대로 하는 거였지 않아?
$^いいの。エステ子にとって、(.+?)を綺麗にするのが仕事なんだから。\1の今の仕事は、エステを受けて綺麗になることなんだよ。$	좋은 거야. 에스테틱 시술사에게는, $1를 깨끗이 하는 것이 일이니까. $1의 지금의 일은, 에스테틱을 받아 깨끗이 되는 것이야.
$^うん、気をつけるようにするよ。(.+?)の横に立っても、見劣りしないようにしないとね。$	응, 조심하도록 할게. $1의 옆에서도 뒤쳐지지 않도록 해야지.
$^なっ……俺より(.+?)のことを分かっているだって！？$	……나보다 $1를 잘 알고 있다고!?
$^(.+?)が挑発するからだろう？　見てろよ、エステ子なんて目じゃないくらいの快感を与えてやるから！$	$1가 도발해서 그럴걸? 봐라, 에스테틱 시술사는 눈이 아닐 정도의 쾌감을 주니까!
$^……ちょ、ちょっと(.+?)。変な声を出しすぎてないか？$	……자, 잠깐 $1. 좀 이상한 소리를 내지 않았어?
$^なんだい、(.+?)？　その歌は？$	뭐야, $1? 그 노래는?
$^忘れて、くださいませ……？　どうも、さっきから、(.+?)のしゃべり方に違和感があるなぁ……？$	잊어, 주십시오……? 아무래도, 조금 전부터, $1의 말투에서 위화감이 느껴지는데……?
$^ああ、やっぱり、いつもと違うよ。いつもの(.+?)は、です、なんて使わないじゃない？$	아, 역시, 평상시와 달라. 평소의 $1는, 입니다, 라는 말투를 사용하지 않았어?
$^まあ、たまには、敬語を使う(.+?)も悪くはないけど、やっぱり、\1は\1らしいのがいいなあ。$	뭐, 가끔씩은, 경어를 사용하는 $1도 나쁘지는 않지만, 역시, $1는 $1다운 게 좋아.
$^そうそう、そんな感じで。ごしごし～って歌いながら、元気にお掃除するのが(.+?)らしいよ。$	그래그래, 그런 느낌으로. 쓱쓱~이라는 노래를 하면서, 건강하게 청소하는 것이 $1인 것 같아.
$^おや、掃除中だったかな、(.+?)？$	이런, 청소중이었는지, $1?
$^ん？　じゃあ、(.+?)の部屋って……？$	응? 그럼, $1의 방은……?
$^おや、この歌声は……(.+?)？ 『たったむ』って何？$	이런, 이 노래는…… $1? 『탓타무』가 뭐야?
$^お掃除か、精が出るね、(.+?)。$	청소인가, 고생하네, $1.
$^かっこいいの！　(.+?)には、このデザインのよさがわからないの？$	근사한 거야! $1는, 이 디자인의 멋을 모르겠어?
$^おや、仕事中かな？　(.+?)。$	이런, 업무중일까? $1.
$^正直言って、(.+?)は、もっとおおざっぱなのかと思ってたから……$	솔직히 말해, $1는, 좀 더 조잡한가라고 생각하고 있었으니까……
$^それはそうだ。じゃあ、その調子で頼むよ、(.+?)。$	그건 그렇네. 그럼, 그 상태로 부탁해, $1.
$^(.+?)、掃除かい？　精が出るね。$	$1, 청소야? 고생하네.
$^ご、ごめん！　ごめんよっ、(.+?)！$	미, 미안! 미안, $1!
$^ごめんて言ってるだろ、許してよ、(.+?)。せめて、口はきいてくれ。$	미안하다고 말했으니까, 용서해 줘, $1. 적어도, 말은 해 줘.
$^わかった、うん。もうしないよ。エッチをするのは(.+?)とだけだ。それじゃ、俺はちょっと用があるから……$	다행이다, 응. 이제 하지 않아. 섹스를 하는 것은 $1 뿐이니까. 그러면, 나는 조금 용무가 있으니까……
$^あ、俺の部屋の掃除をしてくれたの、(.+?)だよね？$	아, 내 방을 청소해준 게, $1지?
$^やっぱり、(.+?)だったか。ありがとう、悪いねぇ。$	역시, $1였구나. 고마워, 나쁘다.
$^(.+?)も、俺とエッチする時に、俺がすぐにイッて終わったら嫌だろ？　だから、\1と少しでも長く楽しめるようにだな……$	$1도, 나와 섹스할 때, 내가 곧바로 가버려서 끝나면 싫겠지? 그러니까, $1와 조금이라도 길게 즐길 수 있도록……
$^おや？　ずいぶん、機嫌がいいみたいだね、(.+?)。何かいいことでも、あった？$	이런? 대단히, 기분이 좋은 것 같네, $1. 뭔가 좋은 일이라도 있었어?
$^どうかしたの、(.+?)？　何か、考え込んでるみたいだけど？$	뭐 하고 있어, $1? 뭔가, 골똘히 생각하고 있는 것 같지만?
$^模様替え？　それで、(.+?)は、この部屋をどう替えるの？$	재배치? 그래서, $1는, 이 방을 어떻게 바꾸려는 거야?
$^おや……家具を入れ替えてるの？　(.+?)。$	이런……가구를 바꿔 넣어? $1.
$^いいと思うよ。(.+?)が選んだの？　いいセンスだね。$	좋다고 생각해. $1가 선택했어? 센스 좋네.
$^あ、そうなの？　じゃあ、(.+?)なら、どういうのを選ぶ？　どんな家具が好きなの？$	아, 그래? 그럼, $1라면, 뭘 고를래? 어떤 가구가 좋아?
$^なるほど、(.+?)らしいなぁ。$	과연, $1인 것 같네.
$^それも(.+?)らしいけど……ん？　夏はしないって……\1は、夏と冬で、年に２回も絨毯を取り換えてるの？$	그것도 $1인 것 같지만……응? 여름은 하지 않는다고…… $1는, 여름과 겨울에, 1년에 2회나 카펫을 교환해?
$^なるほどね。いい物を見るのって、大切だね。……ん？　どうかしたの、(.+?)？$	과연. 좋은 것을 보는 건, 중요하네. ……응? 어떻게 한 거야, $1?
$^で、その間に、俺は炬燵の中の足で、(.+?)のエッチなところをいじる。$	그리고, 그 사이에, 나는 코타츠 안의 다리로, $1의 음란한 곳을 만진다.
$^壁を見て、何を考えてるの？　(.+?)。$	벽을 봐, 무슨 생각을 하는 거야? $1.
$^あ、(.+?)の顔が真っ赤……ごめん、怒った？$	아, $1의 얼굴이 붉어……미안, 화냈어?
$^あ、(.+?)。あれ、すごくよかったよ。$	아, $1. 저거, 꽤 좋았어.
$^向こうの部屋の生け花。あれを生けたの、(.+?)だよね？$	저쪽의 방의 꽃꽂이. 저것을 살린 게, $1지?
$^すっごくきれいだったよ。(.+?)には、そういう才能があったんだね。$	대단히 예뻤어. $1에겐, 그러한 재능이 있었구나.
$^え？　そうだったの？　ごめん、てっきり(.+?)だと思って……じゃあ、誰だろう？$	에? 그랬어? 미안, 틀림없이 $1라고 생각해서……그럼, 누구일까?
$^ん？　なに、(.+?)？$	응? 뭐, $1?
$^んー？　妙に慌ててるね。(.+?)って、ウソがつけないタイプだよね。$	응―？ 묘하게 당황하고 있구나. $1는, 거짓말은 하지 않는 타입이지.
$^ははは、(.+?)は、かわいいな。いいよ、エッチな子は好きだから。$	하하하, $1는, 귀여운데. 좋아, 음란한 아이는 좋아하니까.
$^なるほど、アロマを替えたんだ。(.+?)が選んだの？$	과연, 아로마를 바꿨네. $1가 선택했어?
$^さすが、(.+?)。ひょっとして、\1は自分の部屋にも、ぬいぐるみとか置くタイプ？$	과연, $1. 혹시, $1는 자신의 방에도, 봉제인형이라든지 두는 타입이야?
$^どう？　(.+?)、接客の練習は？$	어때? $1, 접객 연습은?
$^(.+?)？！　顔色が悪いけど、大丈夫？$	$1? 안색이 나쁜데, 괜찮아?
$^急に、何を言い出すんだ……(.+?)だって、大人だろ。でなきゃ、お酒なんて飲ませないよ。$	갑자기, 무슨 말을 하기 시작한다…… $1도, 어른이겠지. 그렇지 않다면, 술은 먹이지 않아.
$^え？　ちょっと待って、(.+?)。なんで急に、ゆで卵の話なの？$	네? 잠깐 기다려, $1. 어째서 갑자기, 삶은 달걀의 이야기야?
$^うーん……(.+?)の場合は、自分がリードしてしゃべるよりも、聞き役に回る方が向いてると思うな。$	응…… $1의 경우는, 자신이 리드해 말하는 것보다도, 듣는 입장으로 돌아가는 게 맞는 것 같아.
$^さて、じゃあ、接客の練習だよ、(.+?)。俺をお客様だと思って。$	자, 그럼, 접객 연습이야, $1. 나를 손님이라고 생각해.
$^(.+?)って、食いしん坊だったんだね……$	$1는, 먹보였구나……
$^ん？　なんで赤くなるの？　俺、(.+?)に、何かした？$	응? 어째서 붉어지는 거야? 나, $1에게, 뭔가 했던가?
$^(.+?)、ずいぶん酔ってない？$	$1, 엄청 취하지 않았어?
$^な、何を言い出すんだ、(.+?)？$	무슨 말을 하는 거야, $1?
$^それだけ、(.+?)が飲ませ上手になったってことかな。$	그만큼, $1가 마시는 데 능숙해졌다는 걸까.
$^(.+?)は、接客の練習も、もうかなり慣れてきたかな？$	$1는, 접객의 연습도, 이제 제법 익숙해진 거야?
$^あ、ああ……でも、(.+?)の酔いが醒めてから、ね。$	아, 아아……그럼 , $1의 취기가 깨고 나서겠네.
$^まぁ、(.+?)なら大丈夫だよ。$	아무튼, $1라면 괜찮아.
$^(.+?)が可愛いし、この子のご奉仕がぎこちないのも、かえって……$	$1가 사랑스럽고, 이 아이의 봉사가 어색한 것도, 오히려……
$^ふふ、(.+?)はエッチだね、この子もいるのに……$	후후, $1는 음란하네, 이 아이도 있는데……
$^エッチだな、(.+?)は。$	음란하다, $1는.
$^まぁね、じゃなきゃ、彼女に(.+?)を見てなんてお願いしないよ。$	뭐, 아니라면야, 그녀에게 $1를 봐달라는 부탁은 하지 않아.
$^俺はメイド全員の事が好きだよ？　(.+?)はすごくトクベツに好きだけどね。$	나는 메이드 전원의 일을 좋아해? $1는 몹시 특별하게 좋아하지만.
$^周囲から、(.+?)の評判が聞こえてくる。$	주위로부터, $1의 평판이 들려온다.
$^(.+?)もエンパイアクラブでの日々に随分慣れてきたようだ。$	$1도 엠파이어 클럽에서의 매일에 상당히 익숙해진 것 같다.
$^これからも(.+?)には頑張ってもらおう。後で褒めてあげないとな。$	앞으로도 $1는 노력하자. 다음에 칭찬해 줄 테니까.
$^そう言って(.+?)は立ち去ってしまった。$	그렇게 말하곤 $1는 떠나 버렸다.
$^(.+?)の目元には、薄らと涙が浮かんでいた。$	$1의 눈매에는, 희미하게눈물이 떠올라 있었다.
$^そっか……強がらなくても良いよ、(.+?)。$	그래…… 강한척 하지 않아도 좋아, $1.
$^俺もその……(.+?)のこと、好きだよ。愛してる。$	나도 그……$1의 일, 좋아해. 사랑하고 있다.
$^じゃあ、(.+?)はどうなの？$	그러면, $1는 어때?
$^ありがとう、(.+?)。$	고마워, $1.
$^はにかむような笑みを浮かべて、(.+?)は俺に甘えてくるのだった。$	부끄러워하는 것 같은 미소를 띄워,$1는 나에게 응석부려 오는 것이었다.
$^俺は(.+?)の言いたい事を何となく察する。$	나는 $1의 말하고 싶은 일을 어쩐지 알 것 같았다.
$^(.+?)は俺に対して、本当に遠慮をしてほしくないようだ。$	$1는 나에 대해서, 정말로 사양하기를 바라지 않는 것 같다.
$^そんな(.+?)と、俺は……$	그런 $1와 나는……
$^そうだね、(.+?)がそこまで言うなら。$	그렇다,$1가 거기까지 말한다면.
$^俺は(.+?)の事が大切だから、優しく夜伽したいかな。$	나는 $1의 일이 중요하기 때문에, 상냥하고 밤시중 하고 싶을까.
$^……不安にさせちゃったかな？　ごめん。俺ももっと、積極的に(.+?)の事を求めるよ。$	…… 불안하게 시켜 버렸을까나? 미안. 나도 좀 더, 적극적으로 $1의 일을 요구한다.
$^(.+?)は少しだけ残念そうな顔をしたが、すぐに微笑んでくれる。$	$1는 약간 유감스러운 얼굴을 했지만, 곧바로 미소지어 준다.
$^そんな可愛くて綺麗な(.+?)と、俺は恋人関係だという事に嬉しさがこみ上げるのだった。$	그렇게 사랑스럽고 예쁜 $1과 나는 연인 관계라고 하는 일에 기쁨이 복받치는 것이었다.
$^はは……(.+?)は相変わらず冷たいな。$	는은……$1는 변함 없이 차가운데.
$^(.+?)は少しの間、沈黙する。$	$1는 조금의 사이, 침묵한다.
$^あくまで比較的な話だけど、女の人は感情を大切にするから……(.+?)は少し変わっているのかもね。$	어디까지나 비교적인 이야기이지만, 여자는 감정을 소중히 하기 때문에……$1는 조금 변하는지도.
$^気にする事はないよ。(.+?)が間違った事をしたとは思えないし。$	신경쓰는 일은 없어. $1가 잘못한 일을 했다고는 생각되지 않고.
$^それに、表情には出ないけれど、(.+?)が色々考えている事、俺には分かるから。$	게다가, 표정에는 나오지 않지만, $1이 여러가지 생각하고 있는 일, 나에게는 알기 때문에.
$^(.+?)は、図星をつかれたのか、恨みがましそうにこちらを見る。$	$1는, 적중을 지쳤는지, 원망하는 듯한 듯이 이쪽을 본다.
$^俺は(.+?)に呼び出されていた。$	나는 $1에 불려 가고 있었다.
$^それも、手書きの手紙で……俺を呼ぶ方法なんて他にいくらでもあるだろうに、(.+?)は手紙で俺を呼び出したのだ。$	그것도, 자필의 편지로…… 나를 부르는 방법 같은거 그 밖에 얼마든지 있을텐데,$1는 편지로 나를 호출한 것이다.
$^どうしたの？　(.+?)。$	무슨 일이야? $1.
$^(.+?)は言いにくそうに口を噤み、俺をじっと見つめる。$	$1는 말하기 어려운 듯이 입을 다물어, 나를 가만히 응시한다.
$^え、ちょ、ちょっと、呼び出したのは(.+?)じゃ……$	네, 조, 조금, 호출한 것은 $1이다……
$^(.+?)はそれっきり黙ってしまう。$	$1는 그것 뿐 입다물고 버린다.
$^俺も好きだよ、(.+?)……それだけいいよね。$	나도 좋아해, $1…… 그 만큼 좋지요.
$^嬉しいよ、(.+?)。$	기뻐, $1.
$^(.+?)がいいんだ。$	$1가 좋다.
$^ほら、(.+?)は表情が少なくなんて無いよ。$	이봐요, $1는 표정이 적고 같은거 없어.
$^そうやって泣いたり喜んだり、俺にはちゃんと分かるから。だから、俺も好きだよ、(.+?)。$	그렇게 울거나 기뻐하거나 나에게는 제대로 알기 때문에. 그러니까, 나도 좋아해,$1.
$^そう言って、(.+?)は俺にだけ魅力的な表情を見せてくれる。$	그렇게 말해, $1는 나에게만 매력적인 표정을 보여 준다.
$^俺と(.+?)は結ばれて、甘い恋人関係になるのだった。$	나와 $1는 연결되어, 달콤한 연인 관계가 되는 것이었다.
$^そう呟く(.+?)は、とても可愛く思えた。$	그렇게 중얼거리는$1은, 매우 사랑스럽게 생각되었다.
$^……分かったよ。(.+?)がそう言うのなら、俺は構わないよ。$	…… 알았어. $1가 그렇게 말한다면, 나는 상관없어.
$^そういう所は(.+?)の可愛いところだけど……そんなに不安にならないでほしいな。$	그러한 곳은 $1의 사랑스러운 곳이지만…… 그렇게 불안하게 안 된으면 좋은데.
$^本当に(.+?)の事が好きなんだ。大切にしたいと思ってる、大事にしてる。$	정말로 $1의 일을 좋아하는 것이다. 소중히 하고 싶다고 생각하고 있다, 소중히 하고 있다.
$^不安にさせてごめん。これからになってしまうけど、俺、(.+?)にもっと好きって伝えるよ。$	불안하게 시켜 미안. 지금부터가 되어 버리지만, 나, $1에 좀 더 좋아한다는 것은 전한다.
$^(.+?)は瞳を潤ませて、ようやく頷いてくれる。$	$1는 눈동자를 물기를 띠게 해, 간신히 수긍해 준다.
$^表情に乏しくて不器用な彼女だけど、俺はそんな(.+?)の事が大好きだった。$	표정이 부족하고 서투른 그녀이지만, 나는 그런 $1의 일을 아주 좋아했다.
$^まあ、でもこれだと、(.+?)が地味だって認めてるようなものだね。ごめん……$	뭐, 그래도 이러면, $1가 평범하다고 인정하는 것 같네. 미안……
$^……(.+?)のそういうところも、俺は好きだよ。$	…… $1의 그런 부분도, 난 좋아해.
$^はは、本当に可愛いよ、(.+?)は……$	하하, 정말 사랑스러워, $1는……
$^どうしたの、(.+?)。いきなり呼び出したりして？$	왜 그래, $1. 갑자기 불러내고
$^俺も好きだよ、(.+?)のことが。$	나도 좋아해, $1를.
$^そっか……じゃあ、本当のことだって、証明してあげるよ。今から俺と(.+?)は、恋人になるんだ。$	그런가……그럼 진실이라고 증명할게. 지금부터 나랑 $1는 애인이야.
$^それで俺が(.+?)のことを好きだって、そう伝えるよ。$	그래서 내가 $1를 좋아한다고, 그렇게 전할게!
$^俺もだよ、(.+?)。$	나도야, $1.
$^(.+?)は泣き笑いのような表情で、俺の胸に飛び込んでくる。$	$1는 희비가 엇갈리는 듯한 표정으로 내 품에 안긴다.
$^どうしたんだ、(.+?)？$	무슨 일이야, $1?
$^いや、俺は(.+?)を大切にしたいから、モノ扱いするようなことは、あまりしたくないんだよ。$	아니, 나는 $1를 소중히 하고 싶으니까, 물건 취급하는 것은, 그다지 하고 싶지 않아.
$^それだけ(.+?)を大切に思ってるって、そう分かって欲しいな。$	그만큼 $1를 소중히 생각하고 있다고, 그렇게 알았으면 좋겠는데.
$^分かったよ、(.+?)。そこまで言うなら、望み通りにしてあげる。$	알았어, $1. 거기까지 말한다면, 바라는대로 해 줄게.
$^ふふ、顔を真っ赤にしちゃって、可愛いね(.+?)は。$	후후, 얼굴이 빨개져서 귀엽네 $1는.
$^これからは、もう甘い顔をしないかもしれないけど……でも、(.+?)のことを好きなのは変わらないからね。$	지금부터는, 이제는 달콤한 얼굴을 하지 않을지도 모르지만……그래도, $1를 좋아하는 것은 변함없으니까.
$^はにかむように笑いながら、(.+?)は嬉しそうに頷いていた。$	수줍게 웃으며, $1는 기쁜듯이 고개를 끄덕였다.
$^言葉だけじゃ不安……か。ごめんね。(.+?)。$	말만으로는 불안했던 것……일까. 미안해. $1.
$^ちょっと大事にし過ぎちゃったかな？　これからは、俺ももっと、(.+?)の事を求めるよ。$	조금 너무 소중하게 다룬 걸까? 앞으로는, 나도 좀 더, $1를 원할게.
$^「大事にし過ぎたかな？」という言葉に、(.+?)は嬉しそうにする。$	「너무 소중하게 다룬 걸까?」라는 말에 $1는 기쁜 듯하다.
$^(.+?)は少しだけ残念そうな顔を浮かべたが、素直に俺の言葉を受け入れてくれる。$	$1는 조금 아쉬운 표정을 지었지만 순순히 내 말을 받아들인다.
$^……俺は(.+?)の事が大好きだよ。本当に。$	……나는 $1의 일을 아주 좋아해. 정말로.
$^俺ができるだけ優しい声で言うと、(.+?)は花が咲くように微笑んでくれるのだった。$	내가 가능한 한 상냥한 소리로 말하자, $1는 꽃이 피듯이 미소지어 주는 것이었다.
$^(.+?)が失敗するなんて、珍しいね。$	$1가 실패하다니 드물다.
$^珍しく仕事で失敗してしまった(.+?)。$	드물게 일로 실패해 버린 $1.
$^事情を聞く為に、俺は(.+?)を呼び出していた。$	사정을 (듣)묻기 위해, 나는 $1를 호출하고 있었다.
$^(.+?)、どうしたの？　ちょっとした冗談なんだけど……$	$1, 왜?　약간의 농담이지만……
$^ああ、確かに俺に(.+?)は勿体無いかもね。$	아, 확실히 나에게 $1는 과분할지도.
$^情熱的だね。(.+?)にそこまで想われるのって、幸せな事だよ。$	정열적이구나. $1에 거기까지 생각해지는 것은, 행복한 일이야.
$^お、惚れた？　俺は(.+?)みたいな可愛くて綺麗な女の子なら――$	, 반했어?　나는 $1같은 사랑스럽고 예쁜 여자 아이라면--
$^俺も、(.+?)がメイドとして俺のところに来てくれて、本当に良かった。$	나도, $1가 메이드로서 나에게 와 주어, 정말로 좋았다.
$^俺は(.+?)に中庭に呼び出されていた。$	나는 $1에 안뜰에 불려 가고 있었다.
$^いつも綺麗な字である(.+?)の字が、俺には少しだけ震えているように思えた。$	언제나 깨끗한 글자인 $1의 글자가, 나에게는 약간 떨고 있는 것처럼 생각되었다.
$^それっきり、(.+?)は黙ってしまう。$	그것 뿐, $1는 입다물고 버린다.
$^俺はただ(.+?)の言葉を待った。$	나는 다만 $1의 말을 기다렸다.
$^言葉では伝えきれないかと思って、俺は(.+?)を抱きしめようとする。$	말에서는 다 ?수 없을까 생각해, 나는 $1를 꼭 껴안으려고 한다.
$^(.+?)は俺を拒んだ。$	$1는 나를 거절했다.
$^(.+?)、そこまで不安に思わなくてもいいんじゃないかな。$	$1, 거기까지 불안하게 생각하지 않아도 괜찮지 않을까.
$^けどさ――と続けようとして、(.+?)の瞳が潤んでいる事に気付く。$	그런데 말이야--와 계속하려고, $1의 눈동자가 물기를 띠고 있는 일을 알아차린다.
$^俺はやっと、(.+?)という女性が分かったような気がする。$	나는 겨우, $1라고 하는 여성이 알 수 있던 것 같은 생각이 든다.
$^俺は(.+?)の事が好きだよ、\1はどうかな？$	나는 $1의 일을 좋아해, $1는 어떨까?
$^(.+?)は何かを堪える様に……けれど、堪えきれずに言葉を紡ぐ。$	$1는 무엇인가를 견디는 것처럼……하지만, 견디지 못하고 말을 뽑는다.
$^(.+?)は見つめあったまま、幸せそうにそう謝ってくる。$	$1는 응시해 머리 뭐, 행복하게 그렇게 사과해 온다.
$^色々な愛情の形があって、(.+?)の想いはちょっとだけ変わってるのかもしれない。$	다양한 애정의 형태가 있어, $1의 구상은 조금 바뀌고 있는지도 모른다.
$^でもまぁ、好きだよ、(.+?)。$	그렇지만 아무튼, 좋아해, $1.
$^(.+?)は一途だね。$	$1는 한결같다.
$^病的な微笑を浮かべ、(.+?)は嬉しそうに頷いていた。$	병적인 미소를 띄워 $1는 기쁜듯이 수긍하고 있었다.
$^信じてくれって言うのは、(.+?)には都合が良過ぎるよね。$	믿어 줘라고 말하는 것은, $1에는 형편이 너무 좋지요.
$^俺は(.+?)をそっと抱き寄せる。$	나는 $1를 살그머니 껴안는다.
$^再び口付けを交わす(.+?)。$	다시 입맞춤을 주고 받는 $1.
$^(.+?)は俺の言葉を待っていたようだった。$	$1는 나의 말을 기다리고 있는 것 같았다.
$^(.+?)の事を、もっといっぱい好きだと伝えるべきだな、と俺は思うのであった。$	$1의 일을, 좀 더 가득 좋아한다고 전해야 한다, 라고 나는 생각하는 것에서 만났다.
$^(.+?)は誰かに何かを教えているようだった、それが終わり一息をついていた。$	$1는 누군가에게 무엇인가를 가르치고 있는 것 같았는데, 그것이 끝나자 한숨 쉬고 있었다.
$^あ、(.+?)だ……お～い、おねえちゃ――$	아, $1다……어~이, 누님--
$^(.+?)は少し、疲れ気味のようだった。$	$1는 조금, 피곤해보이는 것 같았다.
$^――お疲れ様、(.+?)。$	――수고했어, $1.
$^俺は(.+?)の頭を撫でる。$	나는 $1의 머리를 어루만진다.
$^(.+?)、疲れてない？$	$1, 피곤하지 않아?
$^えへへ、と冗談っぽく言う(.+?)だけど、声色は少しだけ疲れていた。$	네에에, 라고 농담 같게 말하는 $1이지만, 음색은 약간 피곤했다.
$^(.+?)はさ……そうだな。周囲にお姉ちゃんっぽく見られてるから、そういう風に、頼られる風に振舞っているのかもしれないね。$	$1는 ……그렇다. 주위에 누나같이 보이고 있으니, 그러한 식으로, 의지되는 바람에 행동하고 있을지도 모른다.
$^(.+?)がらしくしてくれればいい。別に『甘えさせてくれるお姉ちゃん』じゃなくたっていい。逆に俺に甘えたっていいんだよ？$	$1답게 해주면 돼. 딱히『응석부리게 해주는 누나』가 아니어도 좋이. 반대로 나에게 응석부려도 좋아?
$^(.+?)の頬は、照れているのか、朱色に染まっていた。$	$1의 뺨은, 수줍어하고 있는지, 주홍색으로 물들고 있었다.
$^俺が心配しなくても、ずっと(.+?)は\1らしくいてくれたみたいだった。$	내가 걱정하지 않아도, 쭉 $1는 $1답게 있어준 것 같았다.
$^俺は(.+?)の事が大好きだよ。$	나는 $1의 일을 아주 좋아해.
$^……けれど、俺は、何故か(.+?)に呼び出されていた。$	……하지만, 나는, 왠지 모르게 $1에 호출되었다.
$^(.+?)は、本当に俺を心配した様子で、そう言ってくる。$	$1는, 정말로 나를 걱정한 듯, 그렇게 말한다.
$^(.+?)の身体は、柔らかかった。$	$1의 신체는, 부드러웠다.
$^(.+?)の唇が、優しく俺の唇に触れる。$	$1의 입술이, 상냥하게 나의 입술에 닿는다.
$^『ずっと一緒にいてほしい』ではなく『ずっと一緒にいよう』と……俺を包んでくれる(.+?)。$	『계속 함께 있어줘』가 아니라『계속 함께 있자』고……나를 감싸 안아주는 $1.
$^(.+?)、俺は、その……俺は……$	$1, 나는, 그……나는……
$^けれど、(.+?)は答えを急かす事も無く、優しく、とても優しく頷いて待っていてくれる。$	하지만, $1는 재촉하거나 하는 것 없이, 상냥하게, 매우 상냥하게 수긍하여 기다려 주었다.
$^俺も、(.+?)の事が大好きだ。$	나도, $1의 일을 아주 좋아하다.
$^本当に無意識に、俺は(.+?)の唇に唇で触れる。$	정말로 무의식 중에, 나는 $1의 입술에 입술로 닿는다.
$^はは、(.+?)みたいな恋人がいたら……俺はダメになっちゃいそうだ。$	하하, $1같은 애인이 있으면……나는 못쓰게 되어버릴 것 같다.
$^盲目的な口調になり、(.+?)は嬉しそうに頷いていた。$	맹목적인 말투로, $1는 기쁜듯이 수긍하고 있었다.
$^俺は言葉ではない行動を(.+?)に対して行う。$	나는 말이 아닌 행동을 $1에 대해서 실시한다.
$^(.+?)は、今度は素直に俺の言葉を受け入れてくれる。$	$1는, 이번은 솔직하게 나의 말을 받아들여 준다.
$^(.+?)、この間の健康診断の結果が届いてるよ。$	$1, 지난번의 건강검진 결과가 도착했어.
$^見させてもらったけど、(.+?)って意外とたいじゅ――$	일단 보게 되었지만, $1는 의외로 체주――
$^え？　何をかな、(.+?)。$	에? 뭐를, $1.
$^ね、猫カフェ？　オーナー？　あ、う、う～～ん……(.+?)がやりたいなら……でも、\1と一緒にいたいし……$	고, 고양이 카페? 주인? 아, 으, 으~~음…… $1가 하고싶다면…… 그래도, \1과 함께있고 싶고……
$^(.+?)……うぅ……いや、猫なら何とかするから、俺と一緒にいてくれ……！$	$1…… 으음…… 아니, 고양인라면 어떻게든 할테니까, 나와 함께 있어줘……!
$^(.+?)……？　どうして笑ってるの……？$	$1……? 어째서 웃는거야……?
$^……今日はエイプリルフールだ。せっかくだし、(.+?)に嘘をついてからかってやろう……。あ、\1！$	……오늘은 만우절이다. 모처럼이고, $1에게 거짓말을 해서 놀려보자……. 아, $1!
$^実は俺さ……(.+?)にずっと黙っていた事があるんだけど……$	실은 나말이야…… $1에 줄곧 말하지 않은 일이 있는데……
$^実は俺、不治の病にかかっててさ……余命いくばくもないんだよ。だから(.+?)……$	사실 나, 불치병에 걸려버려서 말이야…… 여생이 얼마 남지 않았어. 그러니까 $1……
$^(.+?)。実は俺、不治の病にかかっちゃったんだ。$	$1. 사실 나, 불치병에 걸렸어.
$^（……(.+?)には、嘘をつかない方がいいかもなあ……）$	(……$1에게는, 거짓말을 하지 않는 편이 좋을지도……)
$^エイプリルフールは、無理に嘘をつかなくてもいいんだよ、(.+?)。$	만우절이라고 해서, 무리하게 거짓말은 안 해도 돼 $1.
$^(.+?)ー！　ちょっといいかな？$	$1-! 잠깐 괜찮을까?
$^(.+?)……実は俺、天使の生まれ変わりだったんだよ。$	$1……실은 나, 천사의 환생이었던 거야.
$^今は人間になったから、それは無理なんだよ。悪いな、(.+?)。$	지금은 인간이 되었기 때문에, 그것은 무리야. 나쁘다, $1.
$^そうだな。できる事なら、俺も(.+?)にそうしてあげたかったよ。$	그렇다. 할 수 있는 일이라면, 나도 $1에게 이렇게 해주고 싶었어.
$^結局その後、適当についたエイプリルフールの嘘のために、延々と(.+?)に絡まれる事となったのだった。$	결국 그 후, 적당하게 한 만우절 거짓말 때문에, 끝없이 $1에게 얽히게 되었던 것이었다.
$^(.+?)が室内の様子を窺うように入ってくる。$	$1가 실내의 모습을 엿보듯이 들어온다.
$^俺は(.+?)にジェスチャーでごめんと謝り電話にでる。$	나는 $1에게 손짓으로 미안하다고 사과하며 전화를 받는다.
$^それから数分、電話を終えた俺は(.+?)に向き直る。$	그리고나서 몇분, 전화를 끝낸 나는 $1를 다시 바라본다.
$^また内線だ……(.+?)ごめん、ちょっと待っててね。$	또 내선이다…… $1, 미안, 조금만 기다리고 있어.
$^俺は(.+?)に悪いと思いつつも電話にでる。$	나는 $1에게 미안하다고 생각하면서도 전화를 받는다.
$^ごめん、(.+?)。すぐにステージの方に行かなきゃいけなくなった。$	미안, $1. 바로 스테이지에 가지 않으면 안 되게 됐어.
$^俺は(.+?)の労いの言葉を背に執務室を後にした。$	나는 $1의 응원을 등으로 받으며 집무실을 나갔다.
$^ふいに(.+?)のことが頭によぎる。$	문득 $1가 머릿속에 떠오른다.
$^(.+?)少し、寂しそうだったな……$	$1, 조금 외로운 것 같았지……
$^今からでも、(.+?)のところにいって用件を聞いてみようか……$	지금이라도, $1에게 가서 물어볼까……
$^(.+?)、丁度良いところに。今、呼ぼうか悩んでいたんだ。$	$1, 마침 잘 왔어. 지금 부를까 고민하고 있었어.
$^そっぽ向いて差し出されたものの、(.+?)の表情を見ればそれが精いっぱいの照れ隠しだとわかる。$	다른쪽을 바라보며 건내줬지만, $1의 표정을 보면 그것이 부끄러움을 감추기 위해서라는걸 알 수 있다.
$^あぁ……開ける時が楽しみだ。ありがとう、(.+?)！$	아아…… 열어보는 게 기대되네. 고마워, $1!
$^頬を染めながら聞く(.+?)に、勿論と言うように手招きすると、彼女は俺の腰掛けるベッドに腰を下ろす。$	뺨을 붉히면서 묻는 $1에게 물론이라고 하듯이 손짓 하자, 그녀는 내가 앉아있는 침대 옆에 앉는다.
$^(.+?)は手招きした俺の腕の中にすっぽりと収まる。$	$1는 손짓하던 나의 팔에 쏙 안긴다.
$^なんだか、(.+?)とのキスは甘い感じがするね？$	뭔가, $1랑 키스하니 달콤한 맛이 나네?
$^そう言って優しい笑みを浮かべる(.+?)に愛おしさがこみ上げてくる。$	그렇게 말해 상냥한 미소를 띄운는 $1에게 사랑 아까움이 복받쳐 온다.
$^(.+?)はどこまでも貪欲に俺の事を欲してくれる。$	$1는 탐욕스럽게 나를 원한다.
$^なんだか今日の(.+?)はいつもと違い積極的だった。$	왠지 오늘의 $1는 평소와 달리 적극적이었다.
$^そして(.+?)は導くように俺の手を自らの胸に押し付けた。$	그리고 $1는 나의 손을 이끌어 스스로의 가슴에 갖다댔다.
$^大丈夫、俺は(.+?)以上の幸せを感じているから。$	괜찮아, 난 $1 이상의 행복을 느끼고 있으니까.
$^二本の指で乳輪を伸ばすように(.+?)の胸を弄る。$	2개의 손가락으로 유륜을 주무르며 $1의 가슴을 만지작거린다.
$^(.+?)、ここ弱いね。$	$1, 여기 약하지.
$^そうだね。俺も(.+?)にしてもらうと気持ちいいよ。$	그렇다. 나도 $1가 해주면 기분이 좋아.
$^(.+?)は目を閉じ、啄むようなキスを求める。$	$1는 눈을 감고, 빨아먹을 듯한 키스를 요구한다.
$^すると(.+?)の膣内は愛液で溢れ、その蜜をベットに垂らしていた。$	그러자 $1의 질내는 애액으로 흘러넘쳐, 그 꿀을 침대에 늘어뜨린다.
$^本当に可愛いな、(.+?)は……。$	정말 사랑스럽네, $1는…….
$^愛しさあまって(.+?)の割れ目に指の腹全体が当たるように強くを責め立てていく。$	사랑스러움 남아 $1의 균열에 손가락 안쪽 전체가 맞도록 강하게를 몰아세워 간다.
$^(.+?)は艶のある声を俺に聞かせてくれる。$	$1는 요염함이 있는 소리를 나에게 들려준다.
$^舌を吸い合わせる度に(.+?)の陰裂から愛液が溢れ、ピチピチとイヤらしい音をたてる。$	혀를 섞을 때마다 $1의 야한 입구에서 애액이 흘러넘쳐 찔꺽찔꺽 야한 소리를 낸다.
$^ねぇ、(.+?)そろそろ……$	저기, $1 슬슬……
$^俺はその言葉を皮切りに、(.+?)をベットに押し倒した。$	나는 그 말을 듣자마자, $1를 침대에 넘어뜨렸다.
$^しかし、そのまま彼女の膣内を貪ることはせず、(.+?)の反応を楽しむ。$	그러나, 그대로 그녀의 질내를 탐하지 않고 $1의 반응을 즐긴다.
$^(.+?)が望めば俺はいつだってこうして一緒にいてあげるのに。$	$1가 원한다면 난 언제라도 이렇게 해서 같이 있어 줄텐데.
$^俺は(.+?)に求められるまま、その口元に吸い寄せられていく。$	나는 $1에게 부탁받은 대로, 그 입술 근처를 빨아들인다.
$^ワンテンポ遅れて(.+?)が俺に何をしたかを理解する。$	한 템포 늦게 $1가 나에게 무엇을 했는지 이해한다.
$^(.+?)の膣内がきゅうきゅうと締まり、俺のペニスを捕まえようとする。$	$1의 질내가 큐우큐우하고 꼭죄여, 나의 페니스를 잡으려고 한다.
$^ごめんね。(.+?)が可愛すぎて、もう我慢できないよ。$	미안해. $1가 너무 사랑스러워서, 이제 못 참겠어.
$^大丈夫だよ、俺は(.+?)との大切な時間を一回で終わるつもりはないよ。$	괜찮아, 난 $1와의 소중한 시간을 한번으로 끝낼 생각은 없어.
$^俺は腰を上げ、(.+?)の胸をギュッと掴み、それを支えにして膣壁をさきっちょで擦り上げていく。$	나는 허리를 일으켜 $1의 가슴을 꽉 잡고, 가슴을 지지대 삼아 질벽을 마구 비벼댄다.
$^(.+?)の身体がビクビク震え、身体が弓なりにしなろうとする。$	$1의 몸이 움찔움찔 떨리며 허리가 활처럼 휜다.
$^ふふっ、(.+?)め……。$	후훗, $1녀석…….
$^(.+?)が俺の身体を強引に引き寄せ、唇を奪う。$	$1가 내 몸을 억지로 끌어 당겨 입술을 빼앗는다.
$^すると(.+?)の膣中が何度もキュッと硬直し、絶頂を我慢する。$	그러자 $1의 질속이 몇번이나 꾸욱 경직하며, 절정을 참는다.
$^(.+?)、おれもそろそろイクよっ。$	$1, 나도 슬슬 갈 것 같아.
$^俺のペニスから吐き出された精液は彼女の膣に収まり切れず、(.+?)の愛液と混ざり、零れ落ちていく。$	나의 페니스로부터 뿜어진 정액은 그녀의 질에 전부 들어가지 못하고, $1의 애액과 섞여 넘쳐흐른다.
$^(.+?)、最高だったよ。$	$1, 최고였어.
$^ああっ……そんなこと気にしなくていいのに、俺も(.+?)と一緒に入れて嬉しかったし。$	아앗…… 그런 건 신경 안 써도 되는데, 나도 $1랑 함께 할 수 있어서 기뻤고.
$^(.+?)がそろーっと部屋に入ってくる。$	$1가 슬며시 방에 들어 온다.
$^(.+?)は頬を赤らめ照れる。$	$1는 뺨을 붉히고 부끄러워한다.
$^袋を開けると朝、(.+?)が部屋に入って来た時と同じ匂いがひろがる。$	봉투를 열자 아침에, $1가 방에 들어 왔을 때와 같은 냄새가 퍼진다.
$^しかし、恥ずかしいのは彼女も同じなようで、(.+?)の顔は赤く染め、言葉の切り出し方を探すように視線を宙に彷徨わせていた。$	그러나, 부끄러운 것은 그녀도 마찬가지인 것 같아서, $1의 얼굴은 붉게 물들여 말의 자르는 방법을 찾듯이 시선이 공중에 방황하고 있었다.
$^テーブルランプに照らされ、はにかむ(.+?)に愛おしさがこみ上げてくる。$	테이블 램프에 비쳐져, 부끄러워하는 $1에게 사랑 아까움이 복받쳐 온다.
$^(.+?)は冷えた指に少しだけ難色を示す。$	$1는 차가워진 손가락에 약간 난색을 나타낸다.
$^(.+?)を愛おしく思う気持ちが、指へと反映されていく。$	$1를 사랑 아깝다고 생각하는 기분이, 손가락으로 반영되어 간다.
$^(.+?)は艶のある声をあげる。$	$1는 요염한 목소리를 낸다.
$^そうかな？　俺は(.+?)だけが満足でも構わないけど。$	그런거야? 나는 $1만이 만족해도 상관없는데.
$^俺は(.+?)と一緒に眠るベットの上で、そんなことを考えていた。$	나는 $1와 함께 자는 침대 위에서, 그런 일을 생각하고 있었다.
$^まぁね……(.+?)をないがしろにしたのは事実だし。$	뭐 그렇네…… $1를 소홀히 한 건 사실이고.
$^(.+?)は頬を赤らめ照れたように笑う。$	$1는 뺨을 붉히고 수줍은 듯이 웃는다.
$^てへへと笑う(.+?)に愛おしさがこみ上げてくる。$	데헤헤하고 웃는 $1에게서 사랑스러움이 넘쳐 흐른다.
$^愛しさあまって(.+?)の秘部の割れ目に指の腹全体が当たるように浅いところ強くを責め立てていく。$	사랑스러움이 넘치는 $1의 음부에 손가락을 깊이 넣어 약한 곳을 강하게 몰아붙인다.
$^(.+?)は恥ずかしそうに股をもじもじとすり合わせる。$	$1는 부끄러운 듯이 허벅지를 쭈뼛쭈뼛하며 비빈다.
$^(.+?)は頬を赤らめ照れたようにはにかむ。$	$1는 뺨을 붉히고 부끄러운 것처럼 수줍어한다.
$^悪戯をした子のように笑う(.+?)に愛おしさがこみ上げてくる。$	못된 장난을 한 아이처럼 웃는 $1에게서 사랑스러움이 복받쳐 온다.
$^なんだか今日の(.+?)はいつもより積極的だった。$	어쩐지 오늘의 $1는 평소보다 적극적이었다.
$^わかるよ、俺も(.+?)にしてもらうとそうだし。$	알아, 나도 $1가 해주면 그렇고.
$^なるほどね。可愛い(.+?)のお願いだ。そのお願い、叶えてあげよう。$	과연. 사랑스러운 $1의 부탁이다. 그 부탁을, 실현시켜주자.
$^……(.+?)が望めば俺はいつだってこうして一緒にいてあげるのに。$	……$1가 바라면 나는 언제라도 이렇게 해 함께 있어 주는데.
$^(.+?)の要望に応え先ほどより長く、たっぷりと時間をかけて舌を交える。$	$1의 요망에 응해 방금전보다 길고, 충분히 시간을 들여 혀를 섞는다.
$^勿論だよ……(.+?)のこともっと好きになりそうだよ。$	물론이야…… $1좀 더 좋아하게 될 것 같아.
$^後世にって……俺と(.+?)の子のことなんだ……。$	후세에는…… 나와 $1의 아이의 일이야…….
$^ダイエット？　(.+?)は今のままでも可愛いと思うけど。$	다이어트? $1는 지금 그대로도 사랑스럽다고 생각하지만.
$^あんまり結果を出す事にこだわっても仕方ないと思うけどな。これまで通り、(.+?)の仕事をしてくれればいいと思うよ。$	너무 결과를 내는 일에 관련되어도 어쩔 수 없다고 생각하지만. 이것까지 대로, $1의 일을 해 주면 좋다고 생각한다.
$^妙に肩に力の入っている(.+?)に、俺は漠然とした不安を覚えるのだった。$	묘하게 어깨에 힘이 들어가 있는$1에, 나는 막연히 한 불안을 느끼는 것이었다.
$^ラブリーメイドになって意気込みを見せていた(.+?)が、なにやら落ち込んだ様子で肩を落としていた。$	러블리 메이드가 되어 자세를 보이고 있던 $1이, 어쩐지 낙담한 모습으로 낙담하고 있었다.
$^どうしたの、(.+?)。元気がないじゃないか。$	무슨 일이야, $1. 기운이 없지 않은가.
$^確かに、(.+?)らしくない気がするけど……一体、どうして？$	확실히, $1인것 같지 않은 생각이 들지만…… 도대체, 어째서?
$^身体を壊したら本末転倒だし、(.+?)は今のままで十分に綺麗だよ。$	신체를 부수면 본말 전도이고, $1는 지금 그대로 충분히 예뻐.
$^(.+?)は俺の言葉に、まだ悩んでいる様子だった。$	$1는 나의 말에, 아직 고민하고 있는 모습이었다.
$^溌剌とした様子で、(.+?)は俺に告げる。$	발랄한 모습으로, $1는 나에게 고한다.
$^(.+?)の体調が心配だった俺にとってはいい知らせだった。$	$1의 컨디션이 걱정이었던 나에게 있어서는 좋은 소식이었다.
$^いやいや、一番好きなのは(.+?)の胸だよ。でも、\1が元気になってくれて良かった。これからは無理しないでね。$	아니아니, 제일 좋아하는 것은 $1의 가슴이야. 그렇지만, $1가 건강하게 되어 주어 좋았다. 지금부터는 무리하지 않도록.
$^唐突に(.+?)はそう切り出してきた。$	당돌하게 $1는 그렇게 잘라 왔다.
$^そっか。もう(.+?)はエレガンスメイドだもんね。$	그런가. 이제 $1는 엘레강스 메이드이군.
$^(.+?)は紅茶の勉強を続けているようだった。$	$1는 홍차의 공부를 계속하고 있는 것 같았다.
$^最近、(.+?)の淹れる紅茶がかなり美味しくなってきたように思う。$	최근, $1의 끓이는 홍차가 꽤 맛있어진 것처럼 생각한다.
$^着実に気品を身につけていく(.+?)は、エレガンスメイドになってからというもの、紅茶の勉強会に足を運ぶようになっていた。$	착실하게 기품을 몸에 익혀 가는$1은, elegance 메이드가 되고 나서 부터는, 홍차의 스터디 그룹에 발길을 옮기게 되어 있었다.
$^(.+?)。紅茶の勉強会は、その後どうかな？$	$1. 홍차의 스터디 그룹은, 그 후 어떨까?
$^紅茶の勉強会も終わりを迎えたらしく、すっかりエレガンスメイドとして一流になった(.+?)。$	홍차의 스터디 그룹도 끝을 맞이한 것 같고, 완전히 elegance 메이드로서 일류가 된$1.
$^そのおかげか、最近では(.+?)の淹れてくれる紅茶が楽しみでしょうがない。$	그 덕분인가, 최근에는 $1의 끓여 주는 홍차가 기다려지고 어쩔 수 없다.
$^聞いたことのない名前が出てきたが、(.+?)なら間違いは無いだろう……。$	(들)물은 적이 없는 이름이 나왔지만, $1라면 실수는 없을 것이다…….
$^そして、すぐに(.+?)は戻ってきた。$	그리고, 곧바로$1는 돌아왔다.
$^こんないい気分を味わえるのは、(.+?)のおかげだよ。$	이런 좋은 기분을 맛볼 수 있는 것은, $1의 덕분이야.
$^そう言って静かに微笑む(.+?)には、どこか自信のようなものすら感じられた。$	그렇게 말해 조용하게 미소짓는$1에는, 어딘가 자신과 같은 것조차 느껴졌다.
$^俺は、(.+?)を呼び止める。$	나는, $1를 불러 세운다.
$^ああ、そうしてくれると助かるよ。(.+?)は俺の恋人なんだから。$	아, 그래 해 주면 살아난다. $1는 나의 연인인 것이니까.
$^(.+?)も最近、一段と可愛くなった気がするよ。$	$1도 최근, 한층 사랑스러워진 것 같다.
$^うん、でもやっぱり気をつけてね？　(.+?)が可愛くなるほど、俺は心配なんだから。$	응, 그렇지만 역시 조심해? $1가 사랑스러워질수록, 나는 걱정인 것이니까.
$^子悪魔のように微笑む(.+?)が、俺にはもう充分なほど魅力的に思えた。$	아이 악마와 같이 미소짓는$1이, 나에게는 이제(벌써) 충분한(정도)만큼 매력적으로 생각되었다.
$^なんだかさっきから、(.+?)は溜め息ばかりついていた。$	어쩐지 조금 전부터, $1는 한숨만 붙어 있었다.
$^セクシーメイドになったからなのか、そんな(.+?)の様子もどこか色っぽい。$	섹시 메이드가 되었기 때문인 것인가, 그런 $1의 모습도 어딘가 요염하다.
$^どうしたの(.+?)？　何か、困ってることでもあるの？$	왜$1? 뭔가, 곤란하고 있는 일이라도 있는 거야?
$^(.+?)はどうも、本格的に悩んでいるらしい。$	$1는 아무래도, 본격적으로 고민하고 있는 것 같다.
$^(.+?)は、どう思ってるの？$	$1는, 어떻게 생각하고 있는 거야?
$^どうなんだろう。でもやっぱり、(.+?)が魅力的に見えるのは間違いないんじゃないかな。$	어떨까. 그렇지만 역시, $1가 매력적으로 보이는 것은 틀림없는 것이 아닐까.
$^ゾクゾクするような甘い声で囁く(.+?)。$	오슬오슬 하는 것 같은 달콤한 소리로 속삭이는$1.
$^セクシーメイドとして成長した(.+?)は、今日も惜しみなくその魅力を振りまいている。$	섹시 메이드로서 성장한$1은, 오늘도 아낌없이 그 매력을 뿌리고 있다.
$^この間の同姓にセクハラされたという話をふと思い出して、(.+?)に聞いてみることにした。$	이전의 동성에 성희롱되었다고 하는 이야기를 문득 생각해 내, $1에 들어 보기로 했다.
$^そういえば、(.+?)のお尻を触ってきたメイドはどうしたの？$	그렇게 말하면, $1의 엉덩이를 손대어 온 메이드는 무슨 일이야?
$^妖しげに笑う(.+?)の言葉が、俺に突きささってくる。$	요염한 듯하게 웃는$1의 말이, 나에게 찔러 찔려 온다.
$^お願いしたい事？　なに、(.+?)。$	부탁하고 싶은 일? 뭐, $1.
$^ああ。もし俺が弱ってる時、(.+?)のそんな笑顔を見せられたら、きっと元気づけられるよ。$	아. 만약 내가 약해지고 있는 때, $1의 그런 웃는 얼굴을 보여지면, 반드시 기운을 북돋울 수 있다.
$^(.+?)に暇を出すようになって、しばらくの時間が経った。$	$1에 내보내게 되어, 당분간의 시간이 지났다.
$^以前、よく行く喫茶店のおばあさんが体調を崩してしまい、(.+?)はお店を手伝いたいと言っていた。$	이전, 자주 가는 찻집의 할머니가 컨디션을 무너뜨려 버려, $1는 가게를 돕고 싶다고 하고 있었다.
$^あれからその後が気になった俺は、(.+?)に直接話を聞く事にした。$	그때 부터 그 후가 신경이 쓰인 나는, $1에 직접이야기를 듣는 일로 했다.
$^ねえ、(.+?)。その後、喫茶店の方はどうなったかな。$	저기, $1. 그 후, 찻집은 어떻게 되었을까나.
$^ああ、そうなんだ。お客様って、(.+?)目当てって事？　男の人？$	아, 그렇다. 고객은, $1목적이라는 일? 남자?
$^大好きな(.+?)に、意地悪な事なんてしないよ。それとも、俺の事が信用できない？$	정말 좋아하는$1에, 심술궂은 일 같은거 하지 않아. 그렇지 않으면, 나의 일을 신용 할 수 없어?
$^喫茶店のおばあさんが体調を崩してからというもの、俺は(.+?)の希望に合わせて暇を与えていた。$	찻집의 할머니가 컨디션을 무너뜨리고 나서 부터는, 나는$1의 희망에 맞추어 짬을 주고 있었다.
$^(.+?)が手伝う喫茶店の方も順調らしく、以前よりもお客さんが増えて忙しくなったほどだとか。$	$1가 돕는 찻집도 순조로운 것 같고, 이전보다 고객이 증가해 바빠졌을 정도라든가.
$^そして、それからしばらく経ったある日、(.+?)が俺のところにやってきた。$	그리고, 그리고 당분간 지난 어느 날, $1가 나의 곳에 왔다.
$^それくらい、別に構わないよ。でも(.+?)って、ツンケンしてそうな性格なのに、本当は物凄く優しいよね。$	그 정도, 별로 상관없어. 그렇지만$1은, 뾰루퉁 해 그런 성격인데, 사실은 굉장히 상냥하지요.
$^あはは、(.+?)は可愛いなぁ。$	아하하, $1는 사랑스러운데.
$^そりゃそうだよ。だって、可愛い(.+?)の頼みだからね。無碍にするわけないだろ？$	그것은 그래. 그렇지만, 사랑스러운$1의 부탁이니까. 무애로 할 이유 없을 것이다?
$^いや、だからさ。俺は誰にだって優しいわけじゃないよ。(.+?)以外の人に、こんなに優しくすると思う？$	아니, 그러니까. 나는 누구에게라도 상냥할 것이 아니야. $1이외의 사람에게, 이렇게 상냥하게 한다고 생각해?
$^そんな謙遜はいらないよ。(.+?)は可愛くて素敵なイノセントメイドなんだから、そのままでいてくれればいいよ。$	그런 겸손은 필요없어. $1는 사랑스럽고 멋진 이노센트메이드인 것이니까, 그대로 있어 준다면 좋아.
$^たしかに、(.+?)の笑顔が見られるなら、安いものなのかもしれないけど……$	분명히, $1의 웃는 얼굴을 볼 수 있다면, 싼 것일지도 모르지만……
$^その、そんなのは(.+?)の自由だってわかってるし、ここの経営者として、こんなこと言ったらダメなのかもしれないけど……$	그, 그런 것은 $1의 자유롭다고 알고 있고, 여기의 경영자로서 이런 일 말하면 안 되는 것일지도 모르지만……
$^俺のことを考えて、柔らかく微笑んでくれる(.+?)。$	나의 일을 생각해, 부드럽게 미소지어 주는$1.
$^最近の(.+?)は、チャームメイドとしてますます磨きがかかっていた。$	최근의 $1는, 매력 메이드로서 더욱 더 윤이 걸려 있었다.
$^……決まってる、(.+?)を渡したりなんか、絶対しないよ。$	…… 정해지고 있다, $1를 건네주거나무슨, 절대 하지 않아.
$^よかったぁ。(.+?)がいなくなったら、俺もう生きていけないよ。$	좋았다아. $1가 없어지면, 나 이제(벌써) 살아갈 수 없어.
$^でも、(.+?)は本当にチャームメイドとして、立派になったからね。$	그렇지만, $1는 정말로 매력 메이드로서 훌륭하게 되었기 때문에.
$^以前、(.+?)に対して高価なプレゼントを贈り、ウチのメイドにならないかと誘うお客様がいた。$	이전, $1에 대해서 고가의 선물을 주어, 우리 메이드가 되지 않을까 권하는 고객이 있었다.
$^(.+?)から相談を受けた俺は、絶対に渡したくない、とその想いを伝えて。$	$1로부터 상담을 받은 나는, 절대로 건네주고 싶지 않다, 라고 그 생각을 전해.
$^そして、(.+?)はきちんとそのお客様の誘いを断ってくれたようだ。$	그리고, $1는 제대로 그 고객의 권유를 거절해 준 것 같다.
$^その、断ってもらったんだけど。(.+?)はやっぱり宝石とか、ブランドもののバッグとか欲しいのかな……？$	그, 거절해 받은 것이지만. $1는 역시 보석이라든지, 브랜드의 것의 가방이라든지 갖고 싶은 것인지……?
$^うん……大好きだよ、(.+?)。$	응…… 정말 좋아해, $1.
$^いいんだよ、(.+?)になら。$	좋아, $1에라면.
$^(.+?)のことが、愛しくてたまらない。$	$1의 일이, 사랑스러워서 견딜 수 없다.
$^どうやら俺は本当に、チャームメイドの(.+?)に、虜になってしまったようだった。$	아무래도 나는 정말로, 매력 메이드의$1에, 포로가 되어 버린 것 같았다.
$^ある日、俺と(.+?)は、知人のお客様から舞踏会へと誘われたのだが……。$	어느 날, 나와 $1는, 아는 사람의 고객으로부터 무도회로 권해진 것이지만…….
$^(.+?)に促されて、俺は舞踏会の詳細について話した。$	$1에 촉구받아, 나는 무도회의 상세한 것에 대하여 이야기했다.
$^そうか、助かったよ、(.+?)。さすがレディーメイドだよ。いやぁ、急に誘われると、ちょっと慌てちゃうよね……$	그런가, 살아났어, $1. 과연 레디 메이드야. 아니, 갑자기 권해지면, 조금 당황해 버리네요……
$^そうかな？　(.+?)にそう言ってもらえると助かるけどね。$	그럴까? $1에 그렇게 말해 받을 수 있으면 살아나지만 말야.
$^すごく嬉しいんだけど、何だろう……(.+?)に全てを任せていたら、駄目な人になってしまいそうだよ。$	굉장히 기쁘지만, 무엇일까……$1에 모두를 맡기고 있으면, 안된 사람이 되어 버릴 것 같아.
$^そうか、ありがとう。これからも(.+?)の事、頼りにしてるから。$	그런가, 고마워요. 앞으로도$1의 일, 의지하고 있기 때문에.
$^以前、お客様から舞踏会へと誘われて(.+?)と一緒に出席したことがある。$	이전, 고객으로부터 무도회로 권해져 $1와 함께 출석했던 적이 있다.
$^しかしある日、(.+?)の態度がどこかよそよそしくなった気がして、俺は聞いてみることにした。$	그러나 어느 날, $1의 태도가 어딘가 쌀쌀해진 것 같아, 나는 (들)물어 보기로 했다.
$^あの、(.+?)。ちょっといいかな？$	저, $1. 조금 괜찮을까?
$^いや、その……。この間の舞踏会の時、(.+?)、何かイヤな事でもあったの？$	아니, 그……. 이전의 무도회때, $1, 뭔가 싫은 일이라도 있었어?
$^うぅん……そうだな。そういえば(.+?)、なんだかすごいイケメンの人に誘われて踊ってたよね。$	응…… 그렇다. 그렇게 말하면$1, 왠지 굉장한 이케맨의 사람이 불러 춤추고 있었네요.
$^あぁ、うん。(.+?)って、ダンスが上手だよね。すごい、やっぱりレディーメイドなんだなぁと思ったよ。$	아, 응. $1는, 댄스가 능숙하네요. 굉장해, 역시 레디 메이드야라고 생각했어.
$^うん、わかったよ、(.+?)。これからもよろしく頼むね。$	응, 알았어, $1. 앞으로도 아무쪼록 부탁하네요.
$^(.+?)と会うと、なぜだか彼女はやたらとベタベタしてくるのだった。$	$1와 만나면, 왜일까 그녀는 함부로 끈적끈적 해 오는 것이었다.
$^……えっと、(.+?)？　どうしたの、そんなにベタベタして……$	…… 엣또, $1? 무슨 일이야, 그렇게 끈적끈적 해……
$^そっか。そう言われると(.+?)も文系っぽいね？$	그래. 그런 말을 들으면 $1도 문과 같다?
$^今は(.+?)のことが好きだけど……？$	지금은 $1의 일을 좋아하지만……?
$^(.+?)は、ツンデレって知ってる？$	$1는, 츤데레는 알고 있어?
$^そっか……(.+?)は可憐なところもあるのに、みんな見る目がないなぁ。$	그래……$1는 가련한 곳도 있는데, 모두 보는 눈이 없구나.
$^ありがとう。でも最近は充分、可憐になったと思うよ、(.+?)は。$	고마워요. 그렇지만 최근에는 충분히, 가련하게 되었다고 생각하는, $1는.
$^そういえば(.+?)は、乗馬が得意なんだよね？$	그렇게 말하면 $1은, 승마가 자신있어?
$^なるほど……(.+?)がやったら絵になりそうだね。$	과연……$1가 하면 그림이 될 것 같네.
$^ね、(.+?)。美術館デートしない？$	그런데, $1. 미술관 데이트 하지 않아?
$^(.+?)はさ、お風呂に入ったときどこから洗う？$	$1는, 욕실에 들어갔을 때 어디에서 씻어?
$^はは、(.+?)のことなら、どんなことでも気になっちゃうんだよ。$	는은, $1라면, 어떤 일이라도 신경이 쓰여 버리는거야.
$^うん、そうかも。特に(.+?)にね。$	응, 그럴지도. 특히 $1에 말이야.
$^(.+?)はさ、すごく肌が綺麗だよね。$	$1는, 굉장히 피부가 예쁘네요.
$^やっぱり(.+?)も、ウェディングドレスに憧れてたりするの？$	역시 $1도, 웨딩 드레스를 동경하기도 하는 거야?
$^つい最近見たテレビ番組での結婚特集を思い出して、俺は(.+?)に聞いた。$	바로 최근 본 TV프로에서의 결혼 특집을 생각해 내, 나는 $1에 들었다.
$^そっかそっか。でも確かに、イノセントメイドの(.+?)には、ウェディングドレスの方が似合うかもね。$	그래 그래. 그렇지만 확실히, 이노센트메이드의 $1에는, 웨딩 드레스가 어울릴지도 몰라.
$^もちろんだよ。いつか、(.+?)に着せてあげたいな。$	물론이야. 언젠가, $1에 덮어 씌워 주고 싶은데.
$^はは、どういう意味だろうね。それじゃ(.+?)、俺はそろそろ行くね。$	는은, 어떤 의미일까. 그러면 $1, 나는 슬슬 가네요.
$^(.+?)は真面目だね……イノセントメイドって感じだな。わかった、後で写真を持ってくるよ。$	$1는 성실하다…… 이노센트메이드라는 느낌이다. 알았다, 다음에 사진을 가져온다.
$^(.+?)に似合いの花を見つけたんだ。今度、送るよ。$	$1에 잘 어울리는 꽃을 찾아낸 것이다. 이번에, 보낸다.
$^だって、いつも(.+?)の事を考えていたからさ。何か似合う花はないかなって、調べてみたってわけ。$	왜냐하면, 언제나 $1의 일을 생각하고 있었기 때문에. 뭔가 어울리는 꽃은 없을까 하고, 조사해 보았다는 것.
$^アンスリウムっていう花で、白いやつなんだ。イノセントメイドの(.+?)にぴったりでしょ？$	안스리움이라고 하는 꽃으로, 흰 녀석이야. 이노센트메이드의 $1에 딱 맞겠지?
$^そう？　ちなみに、花言葉は『無垢』だ。これこそ、まさに(.+?)の為の花って感じだろ？$	그렇게? 덧붙여서, 꽃말은 『무구』다. 이것이야말로, 확실히 $1를 위한 꽃이라는 느낌일 것이다?
$^文句を言いながらも恥ずかしそうにしている(.+?)を見て、なんだか俺までドキドキするのだった。$	불평하면서도 부끄러운 듯이 하고 있는 $1을 봐, 뭔가 나까지 두근두근 하는 것이었다.
$^ふと悪戯心が鎌首をもたげたので、俺は(.+?)に意地悪な質問をする事にした。$	문득 장난끼가 굽은 목을 쳐들었으므로, 나는 $1에 심술궂은 질문을 하는 일로 했다.
$^(.+?)さ、もしヌーディストビーチに行く事になったら、どうする？$	$1, 만약 나체주의자 비치에 가는 일이 되면, 어떻게 해?
$^ちょっとした興味本位で聞くんだけどさ。(.+?)って痴漢に遭った事ってある？$	약간의 흥미 본위로 (듣)묻지만. $1라는 치한을 당한 일은 있어?
$^いやいや、(.+?)みたいなエッチなメイドが電車の中にいたら、間違いなく痴漢されるだろうなって思って。$	아니아니, $1같은 엣치한 메이드가 전차 안에 있으면, 틀림없이 치한 될 것이다 되고 생각해.
$^それは、相手が(.+?)だからだよ。チャームメイドの、魔性の魅力ってやつ。$	그것은, 상대가 $1이기 때문이다. 매력 메이드의, 마성의 매력이라는 녀석.
$^恥かしがる姿もどこか色気を漂わせる(.+?)を見て、俺は思わず口端が上がるのを止められないのだった。$	부끄러워하는 모습도 어딘가 색기를 감돌게 하는$1을 봐, 나는 무심코 입 끝이 오르는 것을 멈출 수 없는 것이었다.
$^ふと、(.+?)の耳たぶが俺の視界に入った。$	문득, $1의 귓불이 나의 시야에 들어갔다.
$^(.+?)、ちょっと聞きたいんだけどさ。耳たぶ舐めていい？$	$1, 조금 (듣)묻고 싶지만 말야. 귓불 빨아도 좋아?
$^エッチなメイドで、俺は嬉しいよ、(.+?)。$	엣치한 메이드로, 나는 기뻐, $1.
$^会話の途中、(.+?)はふとそんな言葉を切り出した。$	회화의 도중, $1는 문득 그런 말을 잘랐다.
$^ねえ、(.+?)。ちょっと聞きたい事があるんだけど、いいかな。$	저기, $1. 조금 (듣)묻고 싶은 일이 있지만, 좋을까.
$^舞踏会や社交場なんかに行く時に使う、新しい香水を選びたいんだけど、(.+?)の意見が聞きたくてさ。$	무도회나 사교장 따위에 갈 때에 사용하는, 새로운 향수를 선택하고 싶지만, $1의 의견을 듣고 싶어서 말야.
$^え、本当？　それは助かった。やっぱり(.+?)に聞いて良かったな。$	네, 사실? 그것은 살아났다. 역시$1에 들어 좋았다.
$^そう告げると、早速動き出す(.+?)だった。$	그렇게 고하면, 조속히 움직이기 시작하는$1이었다.
$^ほくほく顔で、(.+?)が早足で俺の元にやってきた。$	싱글싱글 얼굴로, $1가 빠른 걸음으로 나의 곁으로 왔다.
$^ああ、そうだね。ワインもあると嬉しい。そうだ、(.+?)も一緒に食べる？$	아, 그렇네. 와인도 있으면 기쁘다. 그렇다, $1도 함께 먹어?
$^(.+?)は真面目だな。俺は構わないのに。$	$1는 성실하다. 나는 상관없는데.
$^そっか、それもそうだね。(.+?)の分は、後で用意する事にしよう。$	그래, 그것도 그렇다. $1의 분은, 다음에 준비하는 일로 하자.
$^そりゃ、(.+?)はレディーメイドだからね。俺も鼻が高いよ。$	그렇다면, $1는 레디 메이드니까. 나도 거만해.
$^でも、俺は幸せ者だね。(.+?)がメイドになってくれてるんだからさ。$	그렇지만, 나는 행운아구나. $1가 메이드가 되어 주고 있기 때문에.
$^それじゃ、今度俺がネクタイを使う時も、(.+?)に締めてほしいな。$	그러면, 이번내가 넥타이를 사용할 때도, $1에 잡기를 원하는데.
$^そう言って微笑む(.+?)の顔に、俺は穏やかな気持ちになるのだった。$	그렇게 말해 미소짓는$1의 얼굴에, 나는 온화한 기분이 되는 것이었다.
$^お、男の人に？　モテるんだね、(.+?)。$	남자에게? 인기있는 것이군, $1.
$^そりゃ、俺だって(.+?)ともっと一緒にいたいけどね。$	그렇다면, 나도$1와 좀 더 함께 있고 싶지만 말야.
$^揚々と告げる(.+?)はとても魅力的で、俺は思わず彼女に見惚れてしまうのだった。$	양양과 고하는$1은 매우 매력적으로, 나는 무심코 그녀에게 넋을 잃고 봐 버리는 것이었다.
$^いつも直球な(.+?)は、俺に真っ直ぐに問いかけてきた。$	언제나 직구인$1은, 나에게 곧바로에 물어 봐 왔다.
$^まぁ、少なからず(.+?)を独占したい……というか、特別扱いしたいという思いはある。だから専属メイドにしたのだ。$	아무튼, 많이$1를 독점하고 싶은…… 라고 할까, 특별 취급 하고 싶다고 하는 생각은 있다. 그러니까 전속 메이드로 한 것이다.
$^けれどそれを言うと、また(.+?)が過剰に反応してしまいそうな気がする。$	하지만 그것을 말하면, 또$1이 과잉에 반응해 버릴 것 같은 생각이 든다.
$^……(.+?)は専属メイドだけれども、まだまだ距離があるようだった。$	……$1는 전속 메이드이지만도, 아직도 거리가 있는 것 같았다.
$^俺はその、(.+?)を専属にしたぐらいなんだから、もし\1が他の男と一緒にいたらモヤモヤするかな……$	나는 그, $1를 전속으로 한 정도니까, 만약 $1가 다른 남자와 함께 있으면 뭉게뭉게 할까나……
$^そんな事を言いつつも、(.+?)は俺に膝枕をしてくれていた。$	그런 일을 말하면서도, $1는 나에게 무릎 베개를 해 주고 있었다.
$^……ありがとう、(.+?)。$	…… 고마워요, $1.
$^ふわぁ……おはよう、(.+?)。$	후와…… 안녕, $1.
$^(.+?)は、俺にお弁当を差し出してきた。$	$1는, 나에게 도시락을 내며 왔다.
$^あの素直になれない、不器用な(.+?)が……俺にお弁当を作ってくるなんて。$	그 솔직해질 수 없는, 서투른$1이…… 나에게 도시락을 만들어 오다니.
$^いります、(.+?)の手作り弁当！$	필요합니다, $1의 손수 만든 도시락!
$^愛情たっぷりの(.+?)の弁当か……$	애정 충분한$1의 도시락인가……
$^ありがとう、(.+?)。凄く嬉しい。$	고마워요, $1. 굉장히 기쁘다.
$^真面目にお礼を言うと、(.+?)は頬を染めるのだった。$	성실하게 인사를 하면, $1는 뺨을 물들이는 것이었다.
$^ん、どうしたの、(.+?)。$	응, 무슨 일이야, $1.
$^そういうのじゃないんだ。やっぱり。(.+?)への気持ちがあるからトクベツなんだと思う。$	그러한 것이 아니다. 역시. $1에의 기분이 있기 때문에 트크베트인 것이라고 생각한다.
$^(.+?)、何を……$	$1, 무엇을……
$^(.+?)、す、凄いな、積極的だ……$	$1, 괴, 굉장하다, 적극적이다……
$^(.+?)の手は蕩けるような感触で、俺のペニスはすぐに射精の予感を感じる。$	$1의 손의 녹는 듯한 감촉으로, 나의 페니스는 곧바로 사정의 예감을 느낀다.
$^俺の目が覚めるまで、(.+?)はずっと手で奉仕していたのだろう。くちゅくちゅと淫靡な先走りが\1の手に濡れていた。$	내가 깨어날 때까지, $1는 쭉 손으로 봉사하고 있었을 것이다. 질척질척하고 음란한 앞달리기가 $1의 손에 젹셔지고 있었다.
$^くっ……(.+?)、積極的過ぎ……！$	큿…… $1, 적극적이야……!
$^ご主人様として情けないけれど、カリをぐりぐりと刺激する(.+?)の手に、俺はあっという間に射精に導かれる。$	주인님으로서 한심하지만, 칼리를 때굴때굴 자극하는 $1의 손에, 나는 순식간에 사정에 이끌린다.
$^どろどろの精液が、(.+?)の手にべっとりとこびりつく。$	끈적끈적한 정액이, $1의 손에 흠뻑 달라붙는다.
$^(.+?)がいっぱいするからだろ？$	$1가 가득 하기 때문일 것이다?
$^(.+?)が洗ってくれるの？$	$1가 씻어 줄래?
$^(.+?)の魅惑の微笑みに、俺は打ち抜かれてしまう。$	$1의 매혹의 미소에, 나는 뚫려 버린다.
$^その後も、俺は(.+?)に身を任せるのだった。$	그 뒤도, 나는$1에 몸을 맡기는 것이었다.
$^身体が蕩けてしまいそうな快楽。俺は黙って(.+?)に従う事にした。$	신체가 녹아 버릴 것 같은 쾌락. 나는 입다물어$1에 따르는 일로 했다.
$^(.+?)の口内は、俺への気持ちと唾液で熱く湿っている。$	$1의 입 안은, 나에 대한 마음과 타액으로 뜨겁게 축축해져 있었다.
$^俺に頼まれてもいないのに、俺に意識がある訳でもないのに……(.+?)は熱心に奉仕してくれている。$	내가 부탁한 것도 아니고, 나에게 의식이 있는 것도 아닌데…… $1는 열심히 봉사해주고 있다.
$^それが堪らなく嬉しく思ってしまう。すぐに俺は射精の予感を感じ、(.+?)にそれを伝えるが……$	그것이 대단히 기쁘다고 생각해 버린다. 곧바로 나는 사정의 예감을 느껴 $1에 그것을 전하지만……
$^これはこれで気持ちが良い。俺は熱心に裏筋を舌で扱く(.+?)に身を任せる。$	이것은 이것대로 기분이 좋다. 나는 열심히 음경을 혀로 훑는 $1에 몸을 맡긴다.
$^大量の精液が、(.+?)の口内に注がれていく。$	대량의 정액이, $1의 입안에 흘러 들어간다.
$^大量の精液を飲み込んで、(.+?)は淫靡な表情を浮かべる。$	대량의 정액을 삼켜, $1는 음미로운 표정을 띄운다.
$^そうかな、(.+?)が上手いから。$	그럴까, $1가 능숙하니까.
$^俺はそのまま(.+?)に身を任せるのであった。$	나는 그대로$1에 몸을 맡기는 것이었다.
$^そんなことないよ。それに、(.+?)の方が強いんじゃないの？$	그렇지 않아. 게다가, $1가 강한 것이 아닌거야?
$^(.+?)は俺に甘えたいの？$	$1는 나에게 응석부리고 싶은거야?
$^しかし、(.+?)がそんなふうに考えていたとはね。$	그러나, $1가 그런 식으로 생각하고 있었다고는.
$^だって(.+?)が気持ち良かったら、俺も嬉しいからね。$	왜냐하면$1이 기분 좋았으면, 나도 기쁘니까.
$^んー……もちろん俺も、(.+?)と一緒にいられて、幸せだよ。$	응―…… 물론 나도, $1와 함께 있을 수 있어, 행복해.
$^んー……やっぱり(.+?)は可愛いな。$	응―…… 역시 $1는 사랑스러운데.
$^そう言って甘えてくる(.+?)は、本当に可愛らしかった。$	그렇게 말해 응석부려 오는 $1은, 정말로 사랑스러웠다.
$^最近、(.+?)が食べる食事の量が増えた気がする。$	최근, $1가 먹는 식사의 양이 증가한 것 같다.
$^(.+?)はちょっと慌てていた、何か隠し事でもしているのだろうか？$	$1는 조금 당황하고 있던, 뭔가 비밀사항에서도 하고 있을까?
$^この声は……(.+?)？$	이 소리는……$1?
$^(.+?)といえば……以前食事の量の話をした時に、何か隠し事でもしているみたいだったな。$	$1라고 하면…… 이전 식사의 양의 이야기를 했을 때에, 뭔가 비밀사항에서도 하고 있는 것 같았던.
$^しばらく俺は(.+?)の様子を見ていた。$	당분간 나는$1의 상태를 보고 있었다.
$^(.+?)はふわりと微笑んだ。$	$1는 살짝 미소지었다.
$^可愛らしい笑顔を浮かべる(.+?)。$	사랑스러운 웃는 얼굴을 띄우는$1.
$^普段がああだから、何というか、(.+?)のあの声は破壊力がある。$	평상시가 아이니까, 뭐라고 할까, $1의 그 소리는 파괴력이 있다.
$^以前(.+?)が隠して餌を与えていた野良猫を、俺の勧めで、屋敷で飼う事にした。$	이전$1이 숨겨 먹이를 주고 있던 길고양이를, 나의 권유로, 저택에서 기르는 일로 했다.
$^(.+?)もずいぶんと喜んでくれているようで、俺としても嬉しい限りだ。$	$1도 대단히 기뻐해 주고 있는 것 같아, 나로서도 기쁠 따름이다.
$^(.+?)って意外と子供っぽいところがあるのかな？$	$1는 의외로 아이 같은 곳이 있는 것일까?
$^朗らかに微笑む(.+?)。$	명랑하게 미소짓는$1.
$^人よりちょっと、感情の動きが見えないかもしれないけれど、きっと(.+?)は、誰よりも感受性が豊かなのかもしれない。$	사람보다 조금, 감정의 움직임이 안보일지도 모르지만, 반드시$1는, 누구보다 감수성이 풍부할지도 모른다.
$^(.+?)とすれ違うと、すごく幸せな気分になった。$	$1와 엇갈리면, 굉장히 행복한 기분이 되었다.
$^(.+?)の話によると、\1以外のメイドから、立ち振る舞いや仕草の指導をしてほしい、という話が来たようだった。$	$1의 이야기에 의하면, $1이외의 메이드로부터, 행동거지나 행동의 지도를 해 주었으면 하는, 이라고 하는 이야기가 온 것 같았다.
$^(.+?)は少し悩んでいるようで、引き受けるかどうか悩んでいた。$	$1는 조금 고민하고 있는 것 같아, 맡을지 어떨지 고민하고 있었다.
$^やってみたら？　(.+?)なら大丈夫だよ。$	해 보면? $1라면 괜찮아.
$^(.+?)は気品があるからね。それを他人に教えることもできると思うよ。$	$1는 기품이 있으니까요. 그것을 타인에게 가르칠 수도 있다고 생각한다.
$^(.+?)はメイドの指導を引き受ける事を承諾するのだった。$	$1는 메이드의 지도를 맡는 일을 승낙하는 것이었다.
$^(.+?)は夜中に、俺の部屋にやってくる。$	$1는 한밤중에, 나의 방에 온다.
$^どこか心細そうなその声を聞いて、(.+?)が前に、他のメイドの指導を依頼されたと言っていた事を思い出す。$	어딘가 불안한 것 같은 그 소리를 들어, $1가 전에, 다른 메이드의 지도를 의뢰받았다고 한 일을 생각해 낸다.
$^立ち居振る舞いに気品のある(.+?)だからこそ、そんな話が舞い込むのも頷けると思って、俺は背中を押したのだが……。$	행동거지에 기품이 있는$1이기 때문에 더욱, 그런 이야기가 날아 들어오는 것도 납득이 간다고 생각해, 나는 등을 떠민 것이지만…….
$^(.+?)は自信なさげにそう呟く。$	$1는 자신 없는 것 같이 그렇게 중얼거린다.
$^うーん、俺は(.+?)が大丈夫だって思ったからやってみたらって言ったんだ。$	응, 나는$1이 괜찮라도 생각했기 때문에 해 보면라고 말한 것이다.
$^(.+?)は俺の事信じてくれてるよね。だったら俺の信じる\1を信じてみてくれ。$	$1는 나의 일 믿어 주고 있네요. 그렇다면 내가 믿는 $1을 믿어 봐 줘.
$^気の利いた事は言えなかったけど、(.+?)の緊張は解れていたように見えた。$	멋이 있는 일은 말할 수 없었지만, $1의 긴장은 알려지고 있던 것처럼 보였다.
$^(.+?)は、その気品溢れる立ち居振る舞いを買われ、他のメイドの指導を依頼されていた。$	$1는, 그 기품 흘러넘치는 행동거지를 사져 다른 메이드의 지도를 의뢰받고 있었다.
$^しかし、他のメイドへの指導という慣れない行為に頭を悩ませていた(.+?)だったが、俺はご主人様としてアドバイスし、彼女の事を励ました。$	그러나, 다른 메이드에게로의 지도라고 하는 습관 없는 행위에 골머리를 썩고 있던$1이었지만, 나는 주인님으로서 어드바이스 해, 그녀를 격려했다.
$^それが上手くいくかどうかはもちろん(.+?)次第だが、その結果……。$	그것이 능숙하게 갈지 어떨지는 물론 $1나름이지만, 그 결과…….
$^(.+?)のメイドの指導は上手くいったようだった。$	$1의 메이드의 지도는 능숙하게 말한 것 같았다.
$^今日は(.+?)を労う為に、二人でお酒を飲んでいた。$	오늘은$1을 위로하기 위해서(때문에), 둘이서 술을 마시고 있었다.
$^無防備な姿で、(.+?)は眠りこけていた。$	무방비인 모습으로, $1는 골아떨어지고 있었다.
$^最近、(.+?)は妙に色気があって、セクシーメイドに相応するフェロモンを出している。$	최근, $1는 묘하게 색기가 있어, 섹시 메이드에게 상응하는 페로몬을 내고 있다.
$^その言葉に、以前無防備な姿で眠っていた(.+?)を思い出す。$	그 말에, 이전 무방비인 모습으로 자고 있던$1을 생각해 낸다.
$^あー……まぁ、しょうがないかな、(.+?)って色気があるし。$	아―…… 뭐, 어쩔 수 없을까,$1는 색기가 있고.
$^す、すごい事を言うようになったな、(.+?)は……！$	굉장한 일을 말하게 되었군, $1는……!
$^(.+?)は、セクシーメイドに相応するフェロモンを出すようになってからというもの、以前よりも人目を惹くようになっていた。$	$1는, 섹시 메이드에게 상응하는 페로몬을 내게 되고 나서 부터는, 이전보다 남의 눈을 끌게 되어 있었다.
$^その影響か、少し強引なお客様にしつこく絡まれる事もあったようで、(.+?)が苦言を呈していたわけだが……。$	그 영향인가, 조금 강행인 고객으로 해 개 진하게 얽힐 수 있는 일도 있던 것 같아, $1가 고언을 드리고 있던 것이지만…….
$^魅惑的な(.+?)の表情に、俺のほうが戸惑ってしまうのであった。$	매혹적인$1의 표정에, 내 쪽이 당황해 버리는 것이었다.
$^そういう(.+?)の立ち振る舞い……というか仕草は、母性を感じさせた。$	그러한$1의 행동거지…… 라고 할까 행동은, 모성을 느끼게 했다.
$^……(.+?)の雰囲気、いいなぁ。$	……$1의 분위기, 좋은데.
$^可憐な表情を浮かべる(.+?)に、俺はドキっとするのだった。$	가련한 표정을 띄우는$1에, 나는 두근 하는 것이었다.
$^あの時は、俺と(.+?)の二人で相手をしたが、どうも子守りは俺には向かないようだった。$	그 때는, 나와$1의 둘이서 상대를 했지만, 아무래도 아이 보는 사람는 내에는 적합하지 않은 것 같았다.
$^あれから何度か、親戚の子を預かる事があったが全て(.+?)に任せていた。$	그때 부터 몇번인가, 친척인 아이를 맡는 것이 있었지만 모두$1에 맡기고 있었다.
$^小さい子達から、どうやら(.+?)は絶大な信頼を得ているようだった。$	작은 아이들로부터, 아무래도$1는 절대인 신뢰를 얻고 있는 것 같았다.
$^(.+?)は実は表情豊かで優しいって、あの子達には分かるんじゃない？$	$1는 실은 표정 풍부하고 상냥하다고, 그 아이들에게는 아는 것이 아니야?
$^俺の知り合いのご年配の方からも(.+?)の評判はいいし、\1の無垢な感じって、色々な人に評判だよ。$	나의 아는 사람의 나이 있으신 분으로부터도 $1의 평판은 좋고, $1의 무구한 느낌은, 다양한 사람에게 평판이야.
$^それを嫌な顔一つせず話す(.+?)。$	그것을 싫은 얼굴 하나 하지 않고 이야기하는$1.
$^余裕のある笑顔と、溢れ出る気品が、(.+?)のメイドとしての資質を現していた。$	여유가 있는 웃는 얼굴과 넘쳐 나오는 기품이, $1의 메이드로서의 자질을 나타내고 있었다.
$^心なしか、(.+?)は寂しそうな笑顔を浮かべている。$	마음 탓인지, $1는 외로운 것 같은 웃는 얼굴을 띄우고 있다.
$^あれ？　何を読んでいるの、(.+?)。$	어? 무엇을 읽고 있는 것, $1.
$^少しの焦りと、複雑な気持ちになりながらも……俺はこうして(.+?)と一緒にいる事がすごく幸せだった。$	조금의 초조와 복잡한 기분이 되면서도…… 나는 이렇게 해$1와 함께 있는 것이 굉장히 행복했다.
$^(.+?)が日用品の買出しに屋敷を離れた際に、アイドル事務所のスカウトに引っかかったらしい。$	$1가 일용품의 구매에 저택을 떠났을 때에, 아이돌 사무소의 스카우트에 걸린 것 같다.
$^……確かに、可憐さと魅惑を両立したチャームメイドである(.+?)なら、不思議な話ではないのかもしれないが……$	…… 확실히, 가련함과 매혹을 양립한 매력 메이드인$1이라면, 이상한 이야기는 아닌 것인지도 모르겠지만……
$^良かった……まぁ、(.+?)がアイドルとして活躍する姿を見てみたくもあるけどね。$	좋았던…… 뭐, $1가 아이돌로서 활약하는 모습을 보고 싶기도 하지만 말야.
$^ああ……でも、(.+?)がアイドルかぁ……$	아…… 에서도, $1가 아이돌인가……
$^(.+?)の様子に、以前アイドルにスカウトされたという話を思い出す。$	$1의 모습에, 이전 아이돌에 스카우트 되었다고 하는 이야기를 생각해 낸다.
$^あの時の(.+?)は、その話にまるで乗り気ではなかったけど……もしかしたら、やっぱりその気になったのか？$	그 때의$1는, 그 이야기에 전혀 내켜하는 마음은 아니었지만…… 혹시, 역시 그럴 기분이 들었는지?
$^そっか。(.+?)は綺麗だからね、夢中になってしまうお客様がいても不思議じゃないか。$	그래. $1는 예쁘니까, 열중해 버리는 고객이 있어도 이상하지 않은가.
$^チャームメイドである(.+?)の魅力に、お客様が本気になってしまったのだろう。$	매력 메이드인$1의 매력에, 고객이 진지해져 버렸을 것이다.
$^ご、ごめんっ！　そうだよな。(.+?)は俺のメイドだから、その子にはできるだけやんわりと断ってあげてくれ……$	미안! 그렇구나. $1는 나의 메이드이니까, 그 아이에게는 가능한 한 넌지시 거절 해 주어 줘……
$^(.+?)のじとっとした視線を感じながら、俺はイケナイ妄想をしてしまうのだった。$	$1흙막이(sheathing)와로 한 시선을 느끼면서, 나는 안 되는 망상을 해 버리는 것이었다.
$^前に、(.+?)がアイドルにスカウトされたという話は聞いていたけど……それは断るという事で、済んだ話題だと思っていた。$	전에, $1가 아이돌에 스카우트 되었다고 하는 이야기는 듣고 있었지만…… 그것은 거절한다고 하는 일로, 끝난 화제라고 생각하고 있었다.
$^そう考えながら、困惑している様子の(.+?)を見つめる。$	그렇게 생각하면서, 곤혹하고 있는 모습의$1를 응시한다.
$^(.+?)を探していたら、着替え中の\1を見つけてしまった。$	$1를 찾고 있으면, 갈아입음중의 $1를 찾아내 버렸다.
$^それはさておき、レディーメイドである(.+?)はすごく綺麗で可愛らしくなったと思う。$	그것은 접어두어, 레디 메이드인$1은 굉장히 예쁘고 사랑스러워졌다고 생각한다.
$^気品の中にも魅惑的な一面があり、それが男を狂わせる……そんな魅力が(.+?)にはあった。$	기품안에도 매혹적인 일면이 있어, 그것이 남자를 미치게 하는…… 그런 매력이$1에는 있었다.
$^いや、俺が悪かったんだから気にしないで。それにしても(.+?)、綺麗になったよね。$	아니, 내가 나빴던 것이니까 신경쓰지 마. 그렇다 치더라도$1, 예쁘게 되었네요.
$^(.+?)は綺麗になったけど、俺はどうなんだろう？　って感じ。$	$1는 예쁘게 되었지만, 나는 어떨까? 라는 느낌.
$^そういって、(.+?)は俺に微笑む。$	그렇게 말해, $1는 나에게 미소짓는다.
$^(.+?)はどうやら、俺の事を男として磨いてくれるみたいだ。$	$1는 아무래도, 나의 일을 남자로서 닦아 주는 것 같다.
$^俺は(.+?)の隣にふさわしい男になる為に、\1に頼む事にした。$	나는 $1의 옆에 어울리는 남자가 되기 위해서, $1에 부탁하기로 했다.
$^レディーメイドとして気品と可憐さを併せ持つ(.+?)。$	레디 메이드로서 기품과 가련함을 겸비하는$1.
$^俺はご主人様として、そんなメイドの隣に並ぶ事に多少の躊躇いを覚えていたが、(.+?)はそんな俺を男として磨いてくれるという。$	나는 주인님으로서 그런 메이드의 근처에 줄선 일에 다소의 주저함을 기억하고 있었지만, $1는 그런 나를 남자로서 닦아 준다고 한다.
$^そういうの、全部人任せにするのもよくないだろ、それに……レディーメイドの(.+?)の隣に立つ男として、色々勉強したいんだ。$	그러한 것, 전부 사람 맡김으로 하는 것도 좋지 않을 것이다, 거기에…… 레디 메이드의$1의 근처에 서는 남자로서 여러가지 공부하고 싶다.
$^(.+?)なりに気を遣って、俺に声をかけてくれる。$	$1나름대로 배려를 해, 나에게 말을 걸어 준다.
$^それもこれも含め、(.+?)の成長を、俺は実感するのであった。$	그것도 이것도 포함해, $1의 성장을, 나는 실감하는 것이었다.
$^(.+?)が、俺の事を男として磨いてくれるという事になってから、エンパイアクラブのお客様からオペラに招待された。$	$1가, 나의 일을 남자로서 닦아 준다고 하는 일이 되고 나서, 엠파이어 클럽의 고객으로부터 오페라에 초대되었다.
$^かなりのVIPが揃うとの事で、服装選びひとつにしてもずいぶんと頭を悩ませられたものの、(.+?)の協力を得て当日に臨む事ができた。$	상당한 VIP가 갖추어진다라는 일로, 복장 선택 하나로 해도 대단히 골머리를 썩을 수 있었지만, $1의 협력을 얻어 당일에 임할 수가 있었다.
$^それも(.+?)のおかげで、俺は\1を労っていた。$	그것도 $1의 덕분에, 나는 $1을 위로하고 있었다.
$^(.+?)は俺と一緒に同行していたのだが、屋敷に帰ってきてから少し不機嫌そうだった。$	$1는 나와 함께 동행하고 있던 것이지만, 저택에 돌아오고 나서 조금 기분이 안좋은 것 같았다.
$^ごめんね、気をつけるよ。俺の一番は(.+?)だからね。$	미안해요, 조심한다. 나의 제일은$1이니까.
$^はは、まぁ……信じてよ、俺は(.+?)の事が好きだよ。$	는은, 뭐…… 믿어요, 나는$1의 일을 좋아해.
$^(.+?)には悪いけれど、ヤキモチを妬く\1は……凄く、可愛かった。$	$1에는 나쁘지만, 질투를 질투하는 $1은…… 굉장히, 사랑스러웠다.
$^レディメイドとして魅力的になっていく(.+?)だけど、やはり根元は女の子なのだな、と俺は思うのであった。$	레이디 메이드로서 매력적이 되어 가는$1이지만, 역시 근원은 여자 아이이구나, 라고 나는 생각하는 것이었다.
$^言ってしまえば、真っ白な状態のメイドさんというわけだよ、(.+?)。$	말해 버리면, 새하얀 상태의 가정부라고 하는 것이야, $1.
$^うーん、ノービスメイド、かぁ……(.+?)の事どういう風にプロデュースしようかなぁ。$	으음, 노비스 메이드, 흐음…… $1를 어떤 스타일로 프로듀스할까나.
$^そろそろ(.+?)に適した方向性のメイドとして育てていきたいんだ。$	슬슬 $1에게 어울리는 방향성의 메이드로 키워가고 싶다.
$^そんな事無いよ、(.+?)はいつだって可愛いと思うし。$	그런 일 없어, $1는 언제라도 사랑스럽다고 생각하고.
$^ほら、(.+?)……笑ってっ！$	이봐요, $1…… 웃엇!
$^まー、(.+?)がケタケタ笑い始めたら何事かと思うけどね。$	―, $1가 낄낄 웃기 시작하면 무슨 일일까하고 생각하지만 말야.
$^(.+?)との何気ないおしゃべりの間に、少し不思議な反応をする時があった。$	$1와의 아무렇지도 않은 말이 많은 동안에, 조금 이상한 반응을 할 때가 있었다.
$^いや、無理だろ。ど、どうしたの(.+?)っ！　お酒の飲み過ぎ？$	아니, 무리라고. 어, 어째서 $1가! 술을 너무 마셨나?
$^(.+?)、喉が渇いた……紅茶が飲みたいな。$	$1, 목이 마른…… 홍차를 마시고 싶은데.
$^もしかして、この前飲んでいたワインの７３年の？　嬉しいな！　そっか、探していてくれたんだ……(.+?)って気が利くね！$	혹시, 일전에 마시고 있던 와인의 73년의? 기쁜데! 그런가, 찾고 있어 준 것이다……$1는 생각이 잘 미치네요!
$^気品に溢れる(.+?)は、そういう気遣いも出来るようになっていたらしい。$	기품에 흘러넘치는$1은, 그러한 걱정도 할 수 있게 되어 있던 것 같다.
$^(.+?)も俺が喜んでいるのを見て、笑ってくれる。$	$1도 내가 기뻐하고 있는 것을 봐, 웃어 준다.
$^ああ、(.+?)は俺の自慢のメイドだよ。$	아, $1는 나의 자랑의 메이드야.
$^(.+?)の成長を実感しながら、俺はワインに舌鼓を打つのだった。$	$1의 성장을 실감하면서, 나는 와인에 입맛을 다시는 것이었다.
$^あ、(.+?)……お風呂上り？$	아, $1…… 욕실 오름?
$^(.+?)って、お酒を飲むと、ちょっと色っぽくなるよね。$	$1는, 술을 마시면, 조금 요염해지네요.
$^俺はその(.+?)の魅惑的な表情に、目を奪われてしまうのだった。$	나는 그 $1의 매혹적인 표정에, 정신을 빼앗겨 버리는 것이었다.
$^その後、ひたむきにクッキー作りに勤しむ(.+?)の姿を俺はずっと見ていた。$	그 후, 한결같게 쿠키 만들기에 힘쓰는$1의 모습을 나는 쭉 보고 있었다.
$^(.+?)のひたむきさは、イノセントメイドとしてふさわしいものであった。$	$1의 한결같음은, 이노센트메이드로서 적격인 것으로 있었다.
$^(.+?)は俺に一枚の紙を手渡す。$	$1는 나에게 한 장의 종이를 전한다.
$^いいね！　うん、(.+?)に任せるよ。全部追加してもいいよ。$	좋다! 응, $1에 맡긴다. 전부 추가해도 돼.
$^(.+?)は無垢な瞳を俺に向ける。$	$1는 무구한 눈동자를 나에게 향한다.
$^打算の無い表情に、俺は少し驚いた。そんな(.+?)の表情がとても綺麗だったから。$	타산이 없는 표정에, 나는 조금 놀랐다. 그런$1의 표정이 매우 예뻤기 때문에.
$^(.+?)の汗の匂い、好きだけどなぁ。$	$1의 땀의 냄새나, 좋아하지만.
$^そうは言っても、色気のある(.+?)の汗の匂いを嗅ぐ事を止める事ができない。$	그렇게는 말해도, 색기가 있는$1의 땀의 냄새를 맡는 일을 멈출 수가 없다.
$^頬を染めて恥らう(.+?)の様子に、俺は心を奪われていた。$	뺨을 물들여 부끄러워하는 $1의 모습에, 나는 마음이 사로잡히고 있었다.
$^急に(.+?)の身体が近くなり、俺は戸惑ってしまう。$	갑자기 $1의 신체가 가깝게든지, 나는 당황해 버린다.
$^そうやって微笑む(.+?)の表情も、どこか魅惑的なものに俺は感じてしまうのだった。$	그렇게 미소짓는 $1의 표정도, 어딘가 매혹적인 것에 나는 느껴 버리는 것이었다.
$^(.+?)って何フェチ？$	$1라는건 무엇 페티시즘?
$^そういうちょっとマニアックな性癖とか(.+?)にはあるのかなって思って。$	그러한 조금 매니악한 성벽이라든지 $1에는 있는 것일까 하고 생각해.
$^(.+?)は真っ赤な顔をしていた。$	$1는 새빨간 얼굴을 하고 있었다.
$^(.+?)が俺に神妙な雰囲気で顔で話しかけてきた。$	$1가 나에게 신기한 분위기로 얼굴로 말을 걸어 왔다.
$^それに(.+?)のそういう親しさが気に入ってるから。$	거기에 $1의 그러한 친근함이 마음에 들기 때문에.
$^生真面目な(.+?)らしい答え。$	고지식한 $1인것 같은 대답.
$^俺はお湯を頼もうと(.+?)を呼ぶ。$	나는 더운 물을 부탁하려고 $1를 부른다.
$^レディーメイドとして成長を続ける(.+?)だが、俺は少しだけ後悔を覚えるのだった。$	레디 메이드로서 성장을 계속하는 $1이지만, 나는 약간 후회를 느끼는 것이었다.
$^(.+?)は世界三大珍味って食べた事ある？$	$1는 세계 3대 진미는 먹은 일 있어?
$^酒の飲み過ぎだ、(.+?)と一緒に飲んでいた所までは覚えているのだけれども……$	술이 과음한다, $1와 함께 마시고 있던 곳까지는 기억하고 있는 것만……
$^(.+?)は酔っていないし……ああ、情けないな……$	$1는 취하지 않고…… 아아, 한심하구나……
$^情けない俺に、(.+?)はずっと介抱してくれていた。$	한심한 나에게, $1는 쭉 간호해 주고 있었다.
$^(.+?)の存在に、俺は母性のような安心感を覚えるのだった。$	$1의 존재에, 나는 모성과 같은 안심감을 기억하는 것이었다.
$^単刀直入に、(.+?)は俺に対して疑問を投げかける。$	단도직입에, $1는 나에 대해서 의문을 던진다.
$^(.+?)の事を独占したいと思った、俺以外の男に触れてほしくないって思った……それだけだよ。$	$1의 일을 독점하고 싶다고 생각한, 나 이외의 남자가 접하기를 원하지 않다고 생각한…… 그것만이야.
$^はは、(.+?)って本当に鉄壁だよね……$	는은, $1는 정말로 철벽이지요……
$^(.+?)……？　ありがとう。気が利くね。$	$1……? 고마워요. 생각이 잘 미치네요.
$^いや、いい。俺の仕事だ。もう遅いから(.+?)は寝て明日に――$	아니, 좋다. 나의 일이다. 이제 늦었으니까$1는 자 내일에―
$^……うん、ありがとう。なんていうか、(.+?)らしいね。$	…… 응, 고마워요. 뭐라고 할까, $1인것 같다.
$^俺がそういうと、(.+?)は苦笑を浮かべる。$	내가 그렇게 말하면, $1는 쓴웃음을 띄운다.
$^その後、有能な(.+?)が手伝ってくれたおかげで、俺は寝不足にならずに済んだのだった。$	그 후, 유능한 $1이 도와 준 덕분에, 나는 수면 부족이 되지 않고 끝난 것이었다.
$^ありがとう、(.+?)。俺の身の回りのこと、全部任せちゃってるなぁ。$	고마워요, $1. 나의 신변의 일, 전부 맡겨 버리고 있구나.
$^(.+?)がもし母親だったら、自分の子に対して色々気をつけて躾けをしそうだよね。$	$1가 만약 모친이라면, 자신의 아이에 대해서 여러가지 조심해 예의범절을 가르치고를 할 것 같네요.
$^いやぁ、なにか(.+?)はだめな男にひっかかりそうな。$	아니, 뭔가$1는 몹쓸 남자에게 걸릴 것 같은.
$^(.+?)は呆れ顔を浮かべながらも、そこまで嫌がっているようには見えないのだった。$	$1는 기막힌 얼굴을 띄우면서도, 거기까지 싫어하고 있도록(듯이)는 안보이는 것이었다.
$^(.+?)はいつも通りに表情を変えずに『いいわ』と応えて……$	$1는 언제나 대로에 표정을 바꾸지 않고 『좋아요』라고 응해……
$^あ、あんまり(.+?)らしく無い事を言うんだね？$	아, 별로$1인것 같지 않은 것을 말하는 것이군?
$^そっと俺の頬を撫でてくれる(.+?)。$	살그머니 나의 뺨을 어루만져 주는 $1.
$^けれど、(.+?)の性格から考えると、すごく甘い言葉を俺に言ってくれている。$	하지만, $1의 성격으로부터 생각하면, 굉장히 달콤한 말을 나에게 말해 주고 있다.
$^少しずつ、(.+?)から距離をつめてきてくれている。$	조금씩, $1로부터 거리를 채워 와 주고 있다.
$^だから(.+?)から話しかけられたとき、俺はそこそこ驚いた。$	그러니까$1로부터 말을 걸 수 있었을 때, 나는 적당히 놀랐다.
$^だめ、絶対に返さない。絶対に美味しく頂くから。(.+?)の愛情たっぷりのお弁当。$	안돼, 절대로 돌려주지 않는다. 절대로 맛있게 받기 때문에. $1의 애정 충분한 도시락.
$^昼、楽しみにしているよ。ありがとう(.+?)。$	낮, 기대하고 있어. 고마워요$1.
$^(.+?)は突然、俺を強い瞳で見てそう言った。$	$1는 돌연, 나를 강한 눈동자로 봐 그렇게 말했다.
$^(.+?)と二人っきりの時は、俺も本当に一番\1の事が好きなんだ。それじゃダメかな？　分かってくれないかな？$	$1와 단 둘일 때는, 나도 정말로 제일 $1의 일을 좋아하는 것이다. 그러면 안 되는가? 알아 주지 않을까?
$^(.+?)は俺の言葉を聞いて……苦笑を浮かべる。$	$1는 나의 말을 (들)물어…… 쓴웃음을 띄운다.
$^(.+?)の微笑みに、俺は胸の鼓動を早くするのであった。$	$1의 미소지어에, 나는 가슴의 고동을 빨리 하는 것이었다.
$^嬉しいよ、(.+?)……$	기뻐, $1……
$^俺は、積極的な(.+?)に身を任せる事にした。$	나는, 적극적인 $1에 몸을 맡기는 일로 했다.
$^(.+?)がこんなに積極的になるなんてね。$	$1가 이렇게 적극적으로 되다니.
$^(.+?)は喉を鳴らし、俺の吐き出した精液を一滴残らず飲み下す。$	$1는 목을 울려, 내가 토해낸 정액을 한 방울 남김없이 삼킨다.
$^(.+?)はじっとペニスを見て、熱い吐息を感じさせてくれる。$	$1는 가만히 페니스를 봐, 뜨거운 한숨을 느끼게 해 준다.
$^そう言って、(.+?)からの奉仕は続くのであった……$	그렇게 말해, $1로부터의 봉사는 계속되는 것이었다……
$^随分飲んでいたね、(.+?)。$	상당히 마시고 있었군요, $1.
$^酔っ払った(.+?)は可愛かったし。$	몹시 취한$1은 사랑스러웠고.
$^の、飲み過ぎだよ、(.+?)。$	의, 과음하는거야, $1.
$^酔ってるな……(.+?)がそんな事を聞くなんて。$	취하고 있구나……$1가 그런 일을 (듣)묻다니.
$^どう、(.+?)。まだ飲める？　酔いがかなり回ってるなら、もうそろそろ……$	어떻게, $1. 아직 마실 수 있어? 취기가 꽤 돌고 있다면, 이제 슬슬……
$^(.+?)、ノリがいいじゃないか。お酒の力かな。$	$1, 센스가 좋지 않은가. 술의 힘일까.
$^(.+?)も面白い事言うね。俺は別に構わないよ。$	$1도 재미있는 일 말하네요. 나는 별로 상관없어.
$^……(.+?)、すっかり酔っ払ってるね。$	……$1, 완전히 몹시 취하고 있네요.
$^そ、それは仕方ないだろ……。(.+?)が可愛いんだから……俺も思わずドキドキして……$	그것은 어쩔 수 없을 것이다……. $1가 사랑스럽기 때문에…… 나도 무심코 두근두근 해……
$^いやいや、お酒を飲んでなくても、(.+?)は充分に魅力的だよ。本当に。$	아니아니, 술을 마시지 않아도, $1는 충분히 매력적이야. 정말로.
$^お、思ってないよ。……でも(.+?)、明日は二日酔いが酷いかもしれないね。$	생각하지 않아. …… 그렇지만$1, 내일은 숙취가 심할지도 모른다.
$^ふぅ……今日は気持ちよかったよ、(.+?)。$	…… 오늘은 기분 좋았어요, $1.
$^はは、嫌われたくないなぁ、(.+?)には。今、すごく幸せだからさ……$	는은, 미움받고 싶지 않구나, $1에는. 지금, 굉장히 행복하기 때문에……
$^(.+?)、大丈夫？　だいぶ酔ってるみたいだけど。$	$1, 괜찮아? 많이 취하고 있는 것 같지만.
$^(.+?)だけだよ……俺がそんなことするのは。$	$1뿐이야…… 내가 그런 일 하는 것은.
$^それなら今日、一緒に寝ようか、(.+?)。$	그렇다면 오늘, 함께 잘까, $1.
$^何か音が聞こえるね、(.+?)。何だろう？$	무슨 소리가 들리네, $1. 뭐지?
$^(.+?)はやる気だが、まあねずみ相手に説得は無理だろう。屋敷にねずみか……さて、どうすればいいかな。$	$1는 의욕적이지만, 뭐, 쥐를 상대로 설득은 무리겠지. 저택에 쥐인가…… 그럼, 어떻게 하면 좋을까.
$^いきなり、(.+?)が慌てた様子でやってきた。$	갑자기, $1가 당황한 모습으로 찾아왔다.
$^おちついて(.+?)。ねずみというのはこの前話していたねずみかな？$	진정해 $1. 쥐라고 하는 건 예전에 이야기했던 쥐 말야?
$^以前、屋敷に出たというねずみのことを話し始める(.+?)。$	이전에 저택에 나왔다고 하는 쥐의 일을 말하기 시작하는 $1.
$^そう言いながら、ダメでしょうか？とこちらの反応をうかがう(.+?)。$	그럼서, 안될까요? 라고 하며 이쪽의 반응을 살피는 $1.
$^うん、いい考えだと思うよ、(.+?)。庭なら処理することも無いしね。巣箱を作って移してあげるといい。$	응, 좋은 생각이라고 생각해, $1. 뜰이라면 처리하지 않아도 되고. 새집을 만들어 옮겨 주면 좋겠다.
$^天井を見ながら、嬉しそうに心からの笑みを浮かべる(.+?)。この顔を見れただけでも、リスにお礼を言いたくなるくらいだ。$	천정을 바라보며, 진심으로 기쁜듯이 미소를 띄우는 $1. 이 얼굴을 볼 수 있던 것 만으로도, 다람쥐에게 답례를 하고 싶어질 정도다.
$^ストレートな言葉に少しのぼせ気味の顔を隠しつつ、俺は(.+?)と一緒に庭へと歩き出すのだった。$	스트레이트한 말에 조금 붉어진 얼굴을 숨기면서, 나는 $1랑 같이 뜰로 걸어가기 시작하는 것이었다.
$^やけに楽しそうに(.+?)が掃除をしている。いい事でもあったのだろうか。$	몹시 즐거운 듯이 $1가 청소를 하고 있다. 좋은 일이라도 있었던 걸까.
$^(.+?)はそれからもリスの事が気になるのか、ちょくちょく話しかけに行っているらしい。$	$1는 그리고도 다람쥐의 일이 신경쓰였는지, 가끔씩 말을 걸러 가고 있는 것 같다.
$^もっとも、リスの方は(.+?)が恩人だと解っているのかいないのか、気ままに庭で暮らしているだけのようだったが。$	무엇보다, 다람쥐는 $1가 은인이라고 알고 있는지 없는 건지, 멋대로 뜰에서 살고 있을 뿐인 것 같지만.
$^リスの様子を思い出しながら、懸命に語っていた(.+?)だったが、不意に言葉を止めてこちらをじっと見る。$	다람쥐의 모습을 떠올리면서 열심히 말하고 있던 $1였지만, 갑자기 말을 멈추고 이쪽을 가만히 본다.
$^ふわりとこちらに体重を預け、幸せそうにする(.+?)の肩を、俺はそっと抱き寄せるのだった。$	살짝 이쪽에 몸을 맡기고 행복해 하는 $1의 어깨를, 나는 살며시 껴안는 것이었다.
$^どうしたの？　何か相談かな、(.+?)。$	무슨 일이야? 무슨 상담이려나, $1.
$^そんな事はないよ。(.+?)は綺麗なんだし、とっても似合うと思ってるよ。$	그건 아니야. $1는 예쁘고, 너무 잘 어울린다고 생각하고 있어.
$^自信を持って、(.+?)。大丈夫、俺が保証するから。$	자신을 가져, $1. 괜찮아, 내가 보증하니까.
$^早速試してみようとした(.+?)は、回ろうとしたところでバランスを崩し、転んでしまう。$	바로 시험해 보려고 했던 $1는, 돌려다가 밸런스가 무너져서 넘어져 버린다.
$^だ、大丈夫、(.+?)？$	괘, 괜찮아, $1?
$^(.+?)に淹れてもらったコーヒーを一口すする。$	$1가 갖다 준 커피를 한모금 마신다.
$^うん、いつも通り美味しいよ。ありがとう、(.+?)。ほら、一緒に飲もう。$	응, 언제나처럼 맛있어. 고마워, $1. 자, 같이 마시자.
$^いただきますと言いつつ、(.+?)は一向にカップを口に運ぼうとしない。$	잘 마실게요라고 하면서 $1는 전혀 컵을 입에 대려고 하지 않는다.
$^顔をしかめた(.+?)を見て、彼女のコーヒーがブラックだったことに気づいた。$	얼굴을 찡그린 $1를 보고, 그녀의 커피가 블랙이라는 것을 깨달았다.
$^俺がミルクポットとスティックシュガーを渡してあげると、(.+?)は少し迷った後、いつものようにそれをコーヒーに加えた。$	내가 우유 포트와 스틱 설탕을 건네 주니, $1는 조금 망설이다, 평소처럼 그것을 커피에 넣었다.
$^それこそ子供のように可愛い(.+?)の主張を聞いて、思わず小さく吹きだしてしまう。$	그야말로 아이처럼 귀여운 $1의 주장을 듣고, 무심코 장난기가 생긴다.
$^そんなことしなくても十分気品は身についてきたように思えていたが、子供のように顔をしかめてコーヒーを飲む(.+?)を見て、ついつい顔が緩んでしまう俺だった。$	그런 걸 하지 않아도 충분히 기품이 몸에 배었다고 생각하고 있었지만, 아이처럼 얼굴을 찡그리고 커피를 마시는 $1를 보니, 무심코 표정이 느슨해져 버리는 나였다.
$^エレガンスメイドになった(.+?)は、気品あるメイドを目指して頑張り続けていた。$	엘레강스 메이드가 된 $1는, 기품 있는 메이드를 목표로 계속 노력하고 있었다.
$^少しズレているものもあったけど、それなりの成果はあったみたいで、今も(.+?)は頑張っている。$	조금 아닌듯한 것도 있었지만 그만한 성과는 있던 것 같고, 지금도 $1는 노력하고 있다.
$^日課の一つとして気品を身に付けようと努力する(.+?)に、俺は静かに声をかけた。$	업무의 하나로서 기품을 몸에 익히려고 노력하는 $1에게, 나는 조용하게 말을 걸었다.
$^そうして俺に笑顔を向ける(.+?)。その仕草は優雅で、既に十分に気品はあると思う。$	그렇게 나에게 미소를 향하는 $1. 그 행동은 우아해서, 이미 충분하게 기품이 있다고 생각한다.
$^顔を近づけて(.+?)をよく観察する。$	얼굴을 가까이 대고 $1를 자세히 관찰한다.
$^やっぱり……。少し休んだらどう？　……って、(.+?)？　どうしたの、拍子抜けしたような顔をして。$	역시……. 조금 쉬는 게 어때? …… 그, $1? 왜 그래, 김빠진 것 같은 얼굴을 하고.
$^(.+?)はもう十分気品あるメイドだと思うし、今のそのままの君が一番可愛いから。ほら、目を閉じて……。$	$1는 이미 충분히 기품있는 메이드라고 생각하고, 지금 그대로의 네가 제일 사랑스러우니까. 자, 눈을 감아…….
$^そう静かに微笑む(.+?)は、俺の目にはとても美しく気品に満ちた姿に映っていた。$	그렇게 은은하게 미소짓는 $1는, 나의 눈에는 매우 아름답고 기품으로 가득 찬 모습으로 비쳤다.
$^(.+?)、こんな派手なの持ってたのか……$	$1, 이런 화려한 걸 갖고 있었나……
$^つい、(.+?)が実際に履いている所を想像してしまう。$	무심코, $1가 실제로 입고 있는 모습을 상상해 버린다.
$^慌てた様子で、(.+?)はすぐさま俺の手から下着を奪う。$	당황한 모습으로, $1는 바로 나의 손에서 속옷을 빼앗는다.
$^下着を胸に抱えて、顔を真っ赤にする(.+?)。$	속옷을 가슴에 안고, 얼굴을 새빨갛게 하는 $1.
$^そ、その、意外だったよ……。(.+?)がそんな下着を持っているなんて……$	그, 그게 의외였어……. $1가 그런 속옷을 가지고 있다니……
$^怒ってそのまま走り去る(.+?)。$	화내며 그대로 달려가는 $1.
$^この間屋敷で拾った(.+?)の下着のことが頭から離れない。$	얼마 전 저택에서 주운 $1의 속옷이 머릿속에서 떠나지 않는다.
$^(.+?)らしくないけど、セクシーメイドらしい派手な下着。$	$1답지는 않지만, 섹시 메이드다운 화려한 속옷.
$^あの、(.+?)？　この前の下着の事なんだけど……$	저기, $1? 저번의 그 속옷 말인데……
$^え？　(.+?)が謝る事なんてあった？$	에? $1가 사과할 일이라도 있어?
$^ああ、その事か。大丈夫、(.+?)の事を嫌いになったりしないよ。$	아아, 그건가. 괜찮아, $1를 미워하게 되지는 않을게.
$^ちょっとドキッとするような仕草で俺に声をかける(.+?)。$	조금 설레이는 몸짓으로 나에게 말을 거는 $1.
$^あ、ああ。何かな、(.+?)。$	아, 아아. 뭐야, $1.
$^そういえば以前、(.+?)の下着を拾ったときにそんな話もした気がする……。$	그러고 보니 이전, $1의 속옷을 주웠을 때 그런 이야기도 한 것 같다…….
$^うるんだ瞳と上気した頬で(.+?)が俺を見つめる……。$	촉촉한 눈동자와 상기된 뺨으로 $1가 나를 바라본다…….
$^わかった。(.+?)には俺が教えてあげるよ。$	알았어. $1한테는 내가 가르쳐 줄게.
$^ねえ、(.+?)……$	어라, $1……
$^せっせと屋敷の事をこなす(.+?)を見て、なんとなく声をかける。$	부지런히 저택의 일을 하는 $1를 보고, 왠지 모르게 말을 걸었다.
$^よくわからないといった表情を浮かべる(.+?)。$	잘 모르겠다는 표정을 짓는 $1.
$^(.+?)は相変わらずせっせと働いている。$	$1는 변함 없이 부지런히 일하고 있다.
$^今のままで十分幸せだと言っていた(.+?)に、俺は魔法をかけると約束をした。$	지금 그대로 충분히 행복하다고 말한 $1에게, 나는 마법을 걸어주겠다고 약속을 했다.
$^(.+?)、話があるんだけど……$	$1, 할 말이 있는데……
$^俺は手に持っていた手紙のような物を(.+?)に見せる。$	나는 손에 들고 있던 편지같은 것을 $1에 보여준다.
$^目を丸くして驚く(.+?)に、俺は笑って種明かしする。$	눈을 동그랗게 뜨며 놀라는 $1에게, 나는 웃으면서 말한다.
$^もちろん。舞踏会だよ？　綺麗な女性を伴って行くのがマナーだからね。それとも(.+?)は俺とは行きたくないかな？$	물론. 무도회야? 예쁜 여자를 데리고 가는 게 매너니까. 아니면 $1는 나랑 가고 싶지 않은 거야?
$^茶目っ気を出してそう言うと、(.+?)はハッとして驚いたようにこちらを見た後、嬉しそうな笑顔を向ける。$	장난기가 발동해 그렇게 말하니, $1는 깜짝 놀란 듯이 이쪽을 바라본 뒤, 기뻐보이는 미소를 짓는다.
$^頑張って働いていた(.+?)を、俺は約束通り舞踏会に連れて行った。$	열심히 일하고 있던 $1를, 나는 약속대로 무도회에 데려 갔다.
$^その舞踏会の事を思いだしてか、(.+?)がうっとりとした顔をする。$	그 무도회의 일을 떠올린 것인지, $1가 황홀한 표정을 짓는다.
$^そう言って身を寄せてくる(.+?)。$	그렇게 말하며 몸을 기대 오는 $1.
$^小腹がすいてキッチンへとやってくると、(.+?)が鍋を前に首をかしげている。$	배가 고파서 부엌에 왔더니, $1가 냄비를 앞에 두고 고개를 갸우뚱하고 있다.
$^(.+?)が指す鍋を覗き込むと、寸胴の中に大量のスープとその中で煮崩れたじゃがいもが見えた。$	$1가 가리키는 냄비를 들여다 보니, 안에는 대량의 수프와 삶는 동안 뭉개진 감자가 보였다.
$^(.+?)はこれまで主に洋食中心で、あまり和食を作ってくれたことはなかったので、気になって尋ねてみる。$	$1는 지금까지 주로 양식 위주로, 그리 일식을 만들어 준 적이 없었기 때문에 신경이 쓰여 물어 본다.
$^愛想笑いを浮かべる(.+?)。何か言いたくない理由でもあるのかな……？$	억지 미소를 띄우는 $1. 뭔가 말하고 싶지 않은 이유라도 있는 걸까……?
$^いいからいいから。せっかく作ったんだから、味見させてよ。(.+?)の作った物なら失敗作でも構わないから。$	됐어 됐어. 모처럼 만든 거니까, 맛보게 해 줘. $1가 만든 거라면 실패작이라도 상관없으니까.
$^洋食を作ることが多いという(.+?)が和食に挑戦すると言ってから、しばらくの時間が経っていた。$	양식을 만드는 일이 많았던 $1가 일식에 도전하겠다고 하고 나서, 잠시 시간이 흘렀다.
$^俺は(.+?)の作ってくれたご飯を食べ終えて、\1を見た。$	나는 $1가 만들어 준 밥을 다 먹고, $1를 보았다.
$^ごちそうさま、(.+?)。今日も美味しかったよ。$	잘 먹었어, $1. 오늘도 맛있었어.
$^食事を終え、俺は(.+?)の用意してくれたお茶を飲みながら一息つく。$	식사를 끝내고 나는 $1가 준비해 준 차를 마시면서 한숨을 돌린다.
$^そうだったのか。それなら(.+?)が自信が持てたら出してくれたらいいよ。でも\1が作って出してくれる物なら、何でもおいしく食べられるけど。$	그랬구나. 그럼 $1가 자신 있는 걸 만들어 주면 돼. 그리고 $1가 만들어 주는 거라면 뭐든지 맛있게 먹을 수 있는데.
$^初めの方は和食を苦手としていた(.+?)も、段々と腕をあげ、今では和洋中の主だった料理をほとんど作れるようになっていた。$	처음엔 일식으로 골치를 앓던 $1도, 점점 팔을 걷으며 지금은 일본 음식과 일부 서양 요리를 거의 만들 수 있게 되었다.
$^前に苦心していた肉じゃがは、今では(.+?)の得意料理の一つとなっていた。$	전에 고심하고 있던 고기감자조림은, 지금은 $1의 자신있는 요리 중 하나가 되어 있었다.
$^(.+?)の作る食事は何より美味しいよ。いつもありがとう。$	$1가 만드는 식사는 무엇보다 맛있어. 언제나 고마워.
$^もう、(.+?)の料理なしじゃいられなくなってるかも。$	이제, $1의 요리 없이는 살 수 없을지도.
$^そ、そっか……。でも、うん。実際に胃袋を掴まれてる気がするよ。(.+?)に。$	그, 그래……. 그래도, 응. 정말로 입맛을 잡혔다는 생각이 들어. $1에게.
$^お礼を言う(.+?)に、気にしなくていいよ、と返す。$	답례를 하는 $1에게 신경쓰지 않아도 돼, 라고 돌려준다.
$^(.+?)が濡れたタオルを手渡してくれる。それで首筋の汗を拭うと、スッとして気持ち良かった。$	$1가 젖은 수건을 건네 준다. 그걸로 목덜미의 땀을 닦으니 부드럽고 기분 좋았다.
$^俺もだよ(.+?)。たまには庭に出るのもいいよね。$	나도야 $1. 가끔은 정원에 나오는 것도 좋네.
$^でも、(.+?)がガーデニングに興味があるとは知らなかったよ。$	그런데, $1가 원예에 흥미가 있는 줄은 몰랐어.
$^……うん、いいかも知れない。(.+?)に似合うかも。$	…… 응, 좋을지도 모르겠네. $1에게 어울릴지도.
$^うん、きっと(.+?)なら大丈夫だよ。$	응, 분명 $1라면 괜찮아.
$^一緒に庭の手入れをした後、(.+?)の言う事を聞かず、すぐに風呂に入らずに汗をかいたままの服で居たのが悪かったのかもしれない。$	一같이 안뜰의 손질을 하고 나서, $1가 말하는 걸 듣지 않고, 바로 목욕탕에 들어가지 않고 땀을 흘린 채인 옷을 입고 있었던 것이 잘못됐던 걸지도 모른다.
$^責任を感じて涙目になってしまう(.+?)。$	책임을 느끼고 눈물이 고여 버린 $1.
$^(.+?)のせいじゃないから。俺が言う事をちゃんと聞かなかったのが悪いんだって。$	$1 탓이 아니라니까. 내가 말을 잘 안들은 게 나쁜데.
$^それから(.+?)は献身的に看病をしてくれた。$	그리고 $1는 헌신적으로 간병을 해 주었다.
$^あの時はありがとう、(.+?)。$	그 때는 고마웠어, $1.
$^(.+?)の献身的で的確な看護もあって、俺の風邪は長引く事も、そこまで寝込む事も無く完治したのだった。$	$1의 헌신적이고 적절한 간호가 있어서 나의 감기는 오래 끄는 일도, 심하게 드러눕는 일도 없이 완치한 것이었다.
$^頼もしい……というか、(.+?)がしっかりしていたおかげですぐに治ったよ。$	믿음직…… 하다고 할까, $1가 확실하게 해준 덕분에 금방 나았어.
$^涙目で抗議してくる(.+?)。そんなに心配させてしまったのだろうか……。$	눈물 맺힌 눈으로 항의하는 $1. 그렇게 걱정시켜 버린 걸까…….
$^俺は(.+?)をこれからどう育てるか迷っていた。$	나는 $1를 앞으로 어떻게 키울지 고민하고 있다.
$^そうだ、(.+?)自身はどうなりたい？$	맞다, $1 자신은 어떻게 되고 싶어?
$^まだ(.+?)にはこれといった特徴は出ていない。$	아직 $1에게서는 이렇다 할 만한 특징이 나오지 않았다.
$^(.+?)をどういう風に育てたらいいかな……$	$1를 어떤 식으로 키우면 좋으려나……
$^(.+?)！？　ああごめん、そういうつもりじゃなくて。$	$1!? 아아 미안, 그게 아니라.
$^(.+?)はちょっとだけ涙目になる。$	$1는 조금이지만 눈물이 고인다.
$^気にしないで、別にノービスメイドは悪い事じゃないよ。これからどうにだってなれるんだから。ほら、(.+?)はどうなりたい？$	신경쓰지 마, 딱히 노비스 메이드는 나쁜 게 아냐. 지금부터 뭐든지 될 수 있으니까. 자, $1는 어떻게 되고 싶어?
$^(.+?)の声が聞こえたかと思うと、不意に袖を引かれる。$	$1의 목소리가 들렸다고 생각하니, 갑자기 살짝 소매가 끌려진다.
$^な、なに？　(.+?)？$	뭐, 뭐야? $1?
$^俺の袖をちょこんとつまんだまま、(.+?)は聞いてくる。$	나의 소매를 살짝 잡은 채로, $1는 물어 본다.
$^(.+?)はそう言ってパッと袖を放す。$	$1는 그렇게 말하며 갑자기 소매를 놓는다.
$^(.+?)はその、何をしようとしてたの？$	$1는 그, 뭘 하려고 했어?
$^(.+?)が何かの本を集中して読んでいる。$	$1가 어떤 책을 집중해서 읽고 있다.
$^何をみてるのかな、(.+?)。$	뭐 보고 있어, $1.
$^いきなりどうしたの、(.+?)。$	갑자기 무슨 일이야, $1.
$^……うん、(.+?)も一緒になら、楽しいかもしれない。$	…… 응, $1가 함께라면, 즐거울지도 모르겠네.
$^そうだね。それなら、その時は(.+?)をキャディさんにして回ってみるのも面白いかもね。$	그렇네. 그럼, 그때는 $1를 캐디로 해서 돌아보면 재미있을지도 모르겠어.
$^思わせぶりな態度を取るとかもそうだけど、それより(.+?)なら異性に助けてもらえるような隙を見せるのがいいのかもね。$	생각해주는 척하는 태도를 취하는 것도 있지만, 그보다 $1라면 이성에게 도움 받을 수 있는 틈을 보이는 것이 좋을지도.
$^うん、そう。(.+?)の汗の匂い、直接嗅いでみたかったなぁって。$	응, 그래. $1의 땀 냄새, 직접 냄새 맡아 보고 싶구나 해서.
$^けど、恥ずかしそうにしつつもそれを受け入れる(.+?)の可愛い顔も見れたし、当分は黙っておこう。$	하지만, 부끄러운 듯 하면서도 그것을 받아들이는 $1의 사랑스러운 얼굴도 볼 수 있었고, 당분간은 입다물고 있자.
$^キッチンに入ると、(.+?)が小さく何かをつぶやきながら、フライパンを振っている。$	부엌에 들어가니, $1가 작은 소리로 뭔가를 중얼거리면서, 프라이팬을 흔들고 있다.
$^(.+?)、何を作ってるの？$	$1, 뭐 만들고 있어?
$^ねぇ、(.+?)。もし休みが取れたら行きたいところとかある？$	저기, $1. 만약 휴일을 생기면 가고 싶은 곳이라든지 있어?
$^うーん、と頭を捻って考える(.+?)。$	으음, 하고 머리를 갸우뚱하면서 생각하는 $1.
$^自然に囲まれた生活か……。(.+?)がイノセントメイドになれたのって、やっぱりそういう自然が好きっていう事があったからなのかもね……。$	자연에 둘러싸인 생활인가……. $1가 이노센트 메이드가 될 수 있었던 건, 역시 그렇게 자연을 좋아하기 때문일지도…….
$^ちょっと聞いてくれる、(.+?)？　この前に来たお客様が付けていたオパールがすごく綺麗だったんだけど――。$	잠깐 들어 줄래, $1? 저번에 온 손님이 하고 있던 오팔이 엄청 예뻤는데―.
$^俺はこの前に見た、オパールの宝石について(.+?)に話をする。$	나는 저번에 본 오팔 보석에 대해 $1에게 이야기 한다.
$^いつか機会があったら、(.+?)にプレゼントしようか？$	언젠가 기회가 있으면, $1에게 선물 할까?
$^いいから気にしないで。オパールの石言葉も(.+?)にピッタリだし、きっと似合うんじゃないかな。$	괜찮으니까 신경쓰지 마. 오팔의 보석말도 $1에게 딱 맞고, 분명 어울리지 않을까.
$^(.+?)にいたずらっぽい笑みを返しながら、俺はオパールの石言葉を心の中で思い浮かべる。$	$1에게 장난스러운 미소를 돌려주면서, 나는 오팔의 보석말을 마음 속으로 떠올린다.
$^オパールの石言葉は『純真無垢』。これ以上(.+?)に似合う宝石も無いだろう。$	오팔의 보석말은 『순진무구』. 더 이상 $1에게 어울리는 보석은 없을 것이다.
$^ふと見ると、(.+?)が左手を見てため息をついている。$	문득 보니, $1가 왼손을 보며 한숨을 쉬고 있다.
$^どうしたの(.+?)。左手に何かあったの？$	왜 그래 $1. 왼손에 무슨 일 있었어?
$^顔を真っ赤にして言う(.+?)を見て、ようやく俺は気づいた。$	얼굴을 새빨갛게 하고 말하는 $1를 보고, 나는 겨우 눈치챘다.
$^(.+?)に説明するのは難しいなぁ……。$	$1에게 설명하는 건 어려운데…….
$^(.+?)、ちょっと待って。いきなりどうしたの？$	$1, 잠깐만. 갑자기 왜 그래?
$^なんだ、それなら気にしすぎ。(.+?)は十分魅力的だから。$	뭐야, 그럼 너무 신경쓰는 거야. $1는 충분히 매력적이니까.
$^そういう純真な所こそが、チャームポイントなんだよ。だから、(.+?)はそのままで大丈夫。$	그런 순진한 부분이 매력 포인트야. 그니까 $1는 지금 그대로도 괜찮아.
$^まだまだ。我慢して、(.+?)？$	아직. 참아야지, $1?
$^(.+?)は俺の言う通りにその体を強調するポーズを取り、俺の視線に耐えている。$	$1는 내가 말하는 대로 몸매를 강조하는 포즈를 취하고, 나의 시선을 견디고 있다.
$^……。(.+?)、ポーズはもういいよ。だけど――。$	……. $1, 포즈는 이제 됐어. 그리고―.
$^そう答える(.+?)の魅惑的な表情に、俺は吸い寄せられるように唇を重ねるのだった。$	그렇게 대답하는 $1의 매혹적인 표정에, 나는 빨려 들어가듯이 입술을 겹치는 것이었다.
$^俺にエロゲーのプレイを強要された(.+?)が、渋々ゲームをスタートさせる。$	나에게 에로게임의 플레이를 강요받은 $1가, 마지못해 게임을 스타트 시킨다.
$^ちょうど一区切りつき、(.+?)がゲームを終えたところで声をかける。$	마침 일단락되어서 $1가 게임을 끝냈을 때 말을 건다.
$^あ、(.+?)。いきなりだけど、どこか行きたいところはない？$	아, $1. 뜬금없지만, 어디 가고 싶은 곳은 없어? 
$^うん、まあ……。でも、最近の(.+?)を考えたら、逆にそれらしいのかも。$	응, 뭐……. 그래도, 요즘 $1를 생각하면 반대로 그럴 것 같을지도.
$^(.+?)もレディーメイドなわけだし、そういう場所に興味が出るのも自然なのかもしれない。$	$1도 레이디 메이드인 거고, 그런 장소에 관심이 있는 건 자연스러운 걸지도 몰라.
$^落ち着いて、(.+?)。何が上手くいったの？$	진정해, $1. 뭘 제대로 말했어?
$^頑張ったね、(.+?)。さすが俺のメイドだよ。$	열심히 했네, $1. 역시 내 메이드야.
$^うん、ありがとう(.+?)。飲みたくなったらお願いするよ。$	응, 고마워 $1. 마시고 싶으면 부탁할게.
$^(.+?)……。うん、そうだね。そういう\1も見てみたいな。$	$1……. 응, 그렇네. 그런 $1도 보고 싶네.
$^あ、(.+?)。ちょうど良かった。$	아, $1. 마침 잘됐다.
$^ああ、そうそう。ちょっと用事を頼みたいんだけど……ってどうかした、(.+?)？$	아아, 그래 그래. 잠깐 심부름을 부탁하고 싶은데……어, 왜 그래, $1?
$^うん、実はお客様からの意見で気になる事があって――。……(.+?)、本当に大丈夫？　すごい汗だよ？$	응, 실은 손님의 의견으로 신경 쓰이는 게 있어서―. ……$1, 정말 괜찮아? 엄청난 땀인데?
$^……あの、(.+?)。いつも良くしてくれて感謝してるし、少しぐらい休んでも構わないよ？　無理はいけないし……。$	…… 저기, $1. 언제나 잘 해 줘서 감사하고 있고, 조금 쉬어도 괜찮다구? 무리하면 안 되고…….
$^涙目の訴えに、ようやく(.+?)がトイレを我慢していたという事に気づいた。$	눈물 맺힌 호소에, 겨우 $1가 화장실에 가는 걸 참고 있었다는 것을 눈치챘다.
$^(.+?)は内股気味に早足でトイレへと歩いて行った。$	$1는 허벅지를 꼭 붙이며 빠른 걸음으로 화장실에 갔다.
$^あれ(.+?)？　風邪でもひいた？$	어라 $1? 감기라도 걸렸어?
$^……(.+?)、ちょっとこっちに来てくれる？$	……$1, 잠낀 이리 와 볼래?
$^観念して寄って来た(.+?)の額に手を当てると、かなり熱い。$	체념해서 온 $1의 이마에 손을 대니, 꽤나 뜨겁다.
$^(.+?)も一生懸命なのはいいけど、ちょっと生真面目すぎるかな。ちゃんと見ていてあげないと。$	$1는 열심히 하는 건 좋지만, 조금 고지식하려나. 잘 봐주고 있지 않으면.
$^さて、そろそろ出かけよう。(.+?)は準備出来てる？$	자, 슬슬 나가자. $1는 준비 됐어?
$^俺はどっちでもいいよ。少しくらい濡れても構わないし。(.+?)はどうしたい？$	나는 아무래도 좋은데. 조금 쯤은 젖어도 상관없고. $1는 어떻게 하고 싶어?
$^あ、そろそろ時間か……。(.+?)。$	아, 슬슬 시간인가……. $1.
$^(.+?)、\1ってば。$	$1, $1 너.
$^ほら、そろそろ行こう。傘はちゃんと二本持ったし、(.+?)をからかうのは楽しいけど、そろそろ出ないと遅れるからね。$	이봐, 슬슬 가자. 우산은 제대로 두개 갖고 왔어, $1를 놀리는 건 즐겁지만, 슬슬 나가지 않으면 늦으니까 말야.
$^ん？　どうかした、(.+?)？$	응? 왜 그래, $1?
$^(.+?)の声に残念そうな響きを感じる。$	$1의 목소리에 아쉬움이 느껴진다.
$^あれ？　(.+?)としては、その方が起こし易くていいんじゃないの？$	어라? $1로서는, 그 쪽이 깨우기 쉬워서 좋은 거 아냐?
$^一通りの身支度を終え、留守番となる(.+?)に声をかける。$	대충 준비를 하고, 집을 지키게 된 $1에게 말을 건다.
$^無理しちゃダメだよ(.+?)。食事なら外で適当に済ますことも出来るんだし……。$	무리하면 안 돼 $1. 식사라면 밖에서 적당하게 할 수도 있는 거고…….
$^(.+?)……。うん、それじゃ大事に食べさせてもらうよ。本当にありがとう。行ってくるね。$	$1……. 응, 그럼 잘 먹을게. 정말 고마워. 갔다올게.
$^ああ(.+?)、何かな？$	아아 $1, 왜?
$^わかったよ。ごめん(.+?)。……それにしても、\1が怒るのも珍しいよね。なかなか遠慮が無くなって来てるのかな。$	알았어. 미안 $1. …… 그건 그렇고, $1가 화내는 건 드문 일인데. 꽤나 허물이 없어진 거려나.
$^違う違う。責めてるんじゃなくて、嬉しいと思って。それだけ(.+?)は俺に気を許してくれたんだよね？$	아냐 아냐. 꾸짖고 있는 게 아니고, 기쁘다고 생각해서. 그만큼 $1는 나한테 마음을 허락해 준 거지?
$^え、あ……(.+?)！？　な、何を？$	에, 아…… $1!? 무, 무슨?
$^不意の事に驚いたが、(.+?)の一生懸命な様子に気分も高まってくる。$	불의의 일에 놀랐지만, $1의 열심인 모습에 기분이 고양된다.
$^ああ、いいよ……(.+?)。そのまま続けて……。$	아, 좋아…… $1. 그대로 계속해…….
$^(.+?)にしては珍しく積極的だったね……。$	$1치고는 드물게 적극적이었네…….
$^いや、最初はちょっと驚いたけど……気持ちよかったよ。ありがとう、(.+?)。$	아니, 처음은 좀 놀랐는데…… 기분 좋았어. 고마워, $1.
$^(.+?)の声が聞こえたかと思うと、下半身からくちゅくちゅとした音と共に、快感がせりあがってくる。$	$1의 목소리가 들린 것 같다고 생각하자, 하반신으로부터 질척질척한 소리와 함께, 쾌감이 치밀어 온다.
$^え、(.+?)？　そ、その……どうした、の？　くうっ！？$	엑, $1? 그, 그……뭐 하는 거, 야? 크읏!?
$^(.+?)は嬉しそうに俺の吐きだした精液を飲み下した。$	$1는 기쁜듯이 내가 토해낸 정액을 삼켰다.
$^気持ち良かったよ、(.+?)。$	기분 좋았어, $1.
$^うん、もちろん。だって(.+?)があんなにしてくれたから……。って、あ……。$	응, 물론. 왜냐하면 $1가 그렇게 해 주었으니까……. 라고, 아…….
$^さっきまでの(.+?)の姿を思い浮かべてしまい、一度は力を失ったペニスがまた反応してしまう。$	조금 전까지의 $1의 모습을 떠올려 버려, 한 번은 힘을 잃은 페니스가 또 반응해 버린다.
$^いや、そんなつもりじゃなかったんだけど……。でも、そうだな……。もう一度、いいかな。(.+?)？$	아니, 그럴 작정이 아니었지만……. 그렇지만, 그렇네……. 한번 더, 괜찮을까. $1?
$^そうして朝から俺は、(.+?)の奉仕に受け続けるのだった。$	그렇게 해서 아침부터 나는, $1의 봉사를 계속 받는 것이었다.
$^気にしなくていいよ。(.+?)も可愛いから。$	신경 안 써도 돼. $1도 사랑스러우니까.
$^そう？　(.+?)がそう思ってくれるなら、俺も嬉しいよ。$	그래? $1가 그렇게 생각해 준다니 나도 기뻐.
$^……俺もだよ、(.+?)。$	…… 나도야, $1.
$^(.+?)……愛してる、世界中の誰よりも、君のことを。$	$1…… 사랑해, 세상 누구보다도 너를.
$^(.+?)……そんなの、好きに決まってるじゃないか。$	$1…… 그런 거, 좋아하는 게 당연하잖아.
$^そんなことないよ。(.+?)はすっごく可愛い。$	그건 아냐. $1는 엄청 사랑스러워.
$^(.+?)は俺の肩に頭を預けて、幸せそうにうっとりと微笑んでいた。$	$1는 나의 어깨에 머리를 맡기고, 행복한듯이 황홀한 표정으로 미소지었다.
$^ど、どうしたの、(.+?)。いきなり変なこと言って。$	무, 무슨일이야, $1. 갑자기 이상한 일 말해.
$^う、ううん……(.+?)にそう呼ばれると、さすがに違和感があるかも。$	, 으응…… $1에 그렇게 불리면(자), 과연 위화감이 있을지도.
$^そうだなぁ、(.+?)からはもっとこう、上品な感じに呼ばれたい。$	그렇다, $1로부터는 좀 더 이렇게, 품위있는 느낌에 불리고 싶다.
$^ああ、いいっ……いつもと違う感じで、でも(.+?)っぽくて素晴らしいっ。$	아, 좋은 ……평상시와 다른 느낌으로, 그렇지만 $1같고 훌륭하다.
$^ははは、そんなこと気にしなくても、(.+?)に対する俺の気持ちは変わらないよ。$	하하하, 그런 일 신경쓰지 않아도, $1에 대한 나의 기분은 변함없어.
$^でも、そういう意味じゃ旦那様って呼び方は(.+?)によく似合ってると思うけど、あんまり驚きはないかな。$	그렇지만, 그러한 의미는 서방님는 부르는 법은 $1에 잘 어울리고 있다고 생각하지만, 별로 놀라움은 없을까.
$^うぐっ、確かにそれは(.+?)に言われるとドキッとするね……。$	, 확실히 그것은 $1에 말해지면(자) 놀라는군…….
$^お、おおおおおっ、それだ……それだよ！　思いを秘めた感じが(.+?)にぴったりだ！$	, , 그것이다……그것이야!　생각을 숨긴 느낌이 $1에 딱 맞다!
$^どうしたの、(.+?)。もう呼び方を変えるのはやめたの？$	왜, $1. 이제(벌써) 부르는 법을 바꾸는 것은 그만두었어?
$^ああ、ありがとう、(.+?)。いただくよ。$	아, 고마워요, $1. 받아.
$^いいと思うよ、これ。(.+?)、もう一杯もらえる？$	좋다고 생각해, 이것. $1, 한잔 더 받을 수 있어?
$^俺は(.+?)を悲しませるようなことはしない！　頼む、信じてくれ！$	나는 $1를 슬퍼하게 하는 일은 하지 않는다!　부탁하는, 믿어 줘!
$^ごめんな、(.+?)……。$	미안, $1…….
$^来たね、(.+?)。$	왔군요, $1.
$^ホテルもハイヤーも全部予約してある。(.+?)、俺と一緒に京都へ行かないか？$	호텔도 전세 자동차도 전부 예약되어 있다. $1, 나와 함께 쿄토에 가지 않겠는가?
$^(.+?)を旅行に連れて行きたいって思ってね。密かに調べてたんだよ。$	$1를 여행에 데리고 가고 싶다고 생각해. 은밀하게 조사하고 있었어.
$^ははは、(.+?)の驚く顔が見たかったんだ。$	하하하, $1가 놀라는 얼굴을 보고 싶었다.
$^ああ、(.+?)か。こんな夜遅くにどうしたの？$	아, $1인가. 이런 밤 늦게 왜?
$^(.+?)とは別のメイドなんだけど、最近すごくかわいくなってきたなぁって思ってさ。$	$1와는 다른 메이드이지만, 최근 몹시 귀여워졌군라고 생각해.
$^うん、最近チャーミングになってきたなぁ……って顔が怖いよ、(.+?)っ！$	응, 최근 차밍하게 되었군……는 얼굴이 무서워, $1!
$^ちょっと待って！　(.+?)、何を料理するつもりなの！？$	조금 기다려! $1, 무엇을 요리할 생각이야!
$^この前から(.+?)が怒ってるみたいだから……何かプレゼントしようと思うんだけど。$	일전에부터 $1가 화내고 있는 것 같기 때문에……무엇인가 선물 하려고 생각하는데.
$^い、いや俺が好きなのは(.+?)だけだし、ちゃんと気持ちをわかってもらいたいって……！$	있고, 아니내를 좋아하는 것은 $1뿐이고, 분명하게 기분을 알아 주었으면 한다고……!
$^そう言って、(.+?)はカタログを引っ張り出して見せてきた。$	그렇게 말해, $1는 카탈로그를 끌기 시작해 보여 왔다.
$^これ、(.+?)が着るの？$	이것, $1가 입는 거야?
$^でもこれ、(.+?)に似合うかなぁ……いつもつけてるのとかなり方向性が違うよ？$	그렇지만 이것, $1에 어울릴까……언제나 붙여 풀고 되어 방향성이 달라?
$^(.+?)は妖艶な笑みを浮かべ、すすっと近寄ってきた。$	$1는 요염한 미소를 띄워 후루룩 마시고 와 접근해 왔다.
$^い、いやいや！　(.+?)とはいつもしてるよね！？$	있고, 아니아니! $1라고는 언제나 하고 있지!
$^いきなり変なこと頼んで悪かったね、(.+?)。$	갑자기 이상한 일 부탁해 나빴지요, $1.
$^ダメもとで(.+?)に頼んだら快諾してくれた。$	안 됨도로 $1에 부탁하면(자) 쾌락해 주었다.
$^(.+?)は子供好きなの？$	$1는 아이를 좋아해?
$^い、いや、(.+?)は俺の恋人だし、別に構わないけどね。$	있고, 아니, $1는 나의 연인이고, 별로 상관없지만요.
$^ど、どうしよう、(.+?)が本気だ……！$	어, 어떻게 하지, $1가 진심이다……!
$^最近、(.+?)がさりげなく結婚情報誌や育児情報誌を俺の机に置いていくようになった。$	최근, $1가 자연스럽게 결혼 정보지나 육아 정보지를 나의 책상에 두고 가게 되었다.
$^違うってば。俺は(.+?)のことを誰よりも一番に愛してる。$	다르다니까. 나는 $1를 누구보다 제일에 사랑하고 있다.
$^(.+?)が好きだからだよ。子供ができたら\1は子供にかかりきりになっちゃうだろ。$	$1를 좋아하기 때문이다. 아이가 생기면(자) $1는 아이에 다 걸려 가 되어 버리겠지.
$^俺はもう少し、(.+?)と二人の時間を楽しみたいんだよ。$	나는 좀 더, $1와 두 명의 시간을 즐기고 싶어.
$^あ、(.+?)、料理してるんだ。$	아, $1, 요리하고 있어.
$^最近、(.+?)ってみんなからかわいい、色気があるって言われてるよね。$	최근, $1는 모두때문인지 원 좋은, 색기가 있다 라고 말해지고 있지.
$^(.+?)さ、最近チャームメイドとして評判がいいよね。$	$1, 최근 매력 메이드로서 평판이 좋지요.
$^(.+?)が頑張った成果が出てるんだと思うよ。$	$1가 노력한 성과가 나오고 있다라고 생각해.
$^(.+?)の気持ちは嬉しいけど、でも一応ここのメイドなんだしさ……。$	$1의 기분은 기쁘지만, 그렇지만 일단 여기의 메이드야 해 …….
$^うう、何だか(.+?)の手のひらの上って感じだなぁ……。$	우우, 무엇인가 $1의 손바닥 올라 느낌이구나…….
$^いや、大丈夫だよ。(.+?)が傍にいてくれるからね。$	아니, 괜찮아. $1가 옆에 있어 주니까요.
$^今でも十分だよ。(.+?)が通ると振り返るお客様も多いしね。$	지금도 충분해. $1가 통과하면(자) 되돌아 보는 손님도 많기도 하고.
$^や、だってこの前、酔っぱらって暴れたお客様に(.+?)が、その……$	(이)나, 래 일전에, 술취해 날뛰 손님에게 $1가, 그……
$^……うん、(.+?)だけは怒らせちゃいけないな。気をつけよう。$	……응, $1만일 수 있는은 화나게 하면 안 되는데. 조심하자.
$^それに気付かず階下にいた(.+?)を俺がかばってびしょ濡れになってしまった。$	거기에 깨닫지 않고 아래층에 있던 $1를 내가 감싸 흠뻑 젖음이 되어 버렸다.
$^いや、気にしないでいいよ。(.+?)のせいじゃないしね。$	아니, 신경쓰지 말고 좋아. $1의 정사내지.
$^へっくしっ！　……心配してくれてありがとう、(.+?)。$	에 꼬치!　……걱정해 주어 고마워요, $1.
$^はは、(.+?)と一緒にいられないのが少しつらいかなぁ……。$	(은)는은, $1와 함께 있을 수 없는 것이 조금 괴로울까…….
$^だ、ダメだって、こんなに近づいたら(.+?)にうつっちゃうよ……！$	(이)다, 안된다고, 이렇게 가까워지면(자) $1에 옮겨버린다……!
$^そんなの迷信だって……あっ、(.+?)、そんなとこ触ったらっ……。$	그런 것 미신도……, $1, 그런 곳 손대면(자) …….
$^うん、(.+?)のお陰でバッチリ治ったよ。もう風邪なんて怖くないね。$	응, $1의 덕분으로 밧치리 나았어. 이제(벌써) 감기는 두렵지 않다.
$^それより(.+?)、俺の風邪がうつったりしなかった？$	그것보다 $1, 나의 감기가 옮기거나 하지 않았어?
$^(.+?)……ありがとう、心配してくれて。$	$1……고마워요, 걱정해 줘.
$^そう言って、(.+?)は天使のような微笑みを見せるのだった。$	그렇게 말해, $1는 천사와 같은 미소를 보이는 것이었다.
$^いや、(.+?)を今後どういう風に育てていこうかなって思って。$	아니, $1를 향후 어떤 식으로 길러 갈까 되고 생각해.
$^(.+?)はエッチなのと、かわいいのと、上品だったら、どれがいいと思う？$	$1는 음란한과 귀여운 것과 품위있으면, 어떤 것이 좋다고 생각해?
$^(.+?)は今ノービスメイドなんだけど、これからどうしたい？$	$1는 지금 노비스 메이드이지만, 지금부터 어떻게 하고 싶어?
$^俺は今のままでも(.+?)のことは好きだけど……。$	나는 지금 그대로도 $1는 좋아하지만…….
$^い、いや、(.+?)には似合わないんじゃないかな……。$	있고, 아니, $1에는 어울리지 않지 않을까…….
$^(.+?)は自分を動物に例えるとしたら何だと思う？　犬？　猫？$	$1는 자신을 동물에 비유한다고 하면(자) 무엇이라고 생각해?　개?　고양이?
$^へえ、(.+?)と踊るのは楽しそうだな。$	에 네, $1와 춤추는 것은 즐거운 듯 하다.
$^は、ははは……(.+?)らしいなぁ。$	(은)는, 하하하…… $1인것 같다.
$^よし、俺も今度(.+?)に何か贈り物をしてあげよう。$	좋아, 나도 이번 $1에 무엇인가 선물을 해 주자.
$^(.+?)ってザクロが好きだったんだ。$	$1는 석류나무를 좋아했었어.
$^珍しいね。(.+?)が中華を作るなんて。$	드물다. $1가 중화를 만들다니.
$^ははは、(.+?)は真面目だなぁ。気遣ってくれてありがとね。$	하하하, $1는 성실하다. 신경써 주어 고마워.
$^どうしたの、(.+?)。変な顔して。$	왜, $1. 이상한 얼굴 해.
$^あはは、真面目な(.+?)らしいね。十円ぐらいじゃ届ける人はまずいないよ。$	아하하, 성실한 $1인것 같다. 10엔 정도는 보내는 사람은 안된다 있어라.
$^(.+?)は子供好き？$	$1는 아이를 좋아하는 사람?
$^なな、なに突然！？　純真無垢な……イノセントメイドである(.+?)がエロゲーなんて言葉を口にするなんて……！$	없는, 뭐돌연!　순진무구인……이노센트메이드인 $1가 에로게임같은 말을 말하다니……!
$^でも、(.+?)は中二病って感じじゃないかも。どっちかって言うと和風だし。$	그렇지만, $1는 중2병이라는 느낌이 아닐지도. 어느 쪽인가라고 말하면(자) 일본식이고.
$^う、うん……(.+?)にも十分素質はあるんだね……。$	, 응…… $1에도 충분히 소질은 있는 것이군…….
$^う、ううん、(.+?)には向いてないんじゃないかなぁ。$	, 으응, $1에는 향하지 않지 않을까.
$^(.+?)はどちらかというと昼ドラとかの方が似合ってると思う。$	$1는 어느 쪽인가 하면 낮드라라든지(분)편이 어울리고 있다고 생각한다.
$^い、いきなりキスされた……(.+?)、何かあったの……？$	있고, 갑자기 키스 된…… $1, 무엇인가 있었어……?
$^そうだなぁ、どっちかと言えば緑茶かな。(.+?)が来てからは特に緑茶だね。$	그렇다, 어느 쪽일까하고 말하면 녹차일까. $1가 오고 나서는 특히 녹차구나.
$^うん、(.+?)が気を使ってよく持ってきてくれるからね。それで好きになったんだよ。$	응, $1가 신경을 써 잘 가져와 주니까요. 그래서 좋아하게 되었어.
$^順調に(.+?)の色に染められてるって感じかな。$	순조롭게 $1의 색에 물들일 수 있고 있다고 느낌일까.
$^ねえ、(.+?)。ヤンデレって知ってる？$	저기, $1. 얀데레는 알고 있어?
$^だ、大丈夫だから！　ずっと(.+?)一筋だからね。$	(이)다, 괜찮기 때문에!　쭉 $1외곬이니까.
$^(.+?)なら、そう言うんじゃないかと思ってね。$	$1라면, 그렇게 말하지 않을까 생각해.
$^(.+?)は少し、病的なところがあるからな……$	$1는 조금, 병적인 곳이 있기 때문인……
$^(.+?)が微笑む。$	$1가 미소짓는다.
$^(.+?)か……こんな夜遅くにどうしたの？$	$1인가……이런 밤 늦게 왜?
$^そう言って(.+?)は頬を赤く染める。$	그렇게 말해 $1는 뺨을 붉게 물들인다.
$^ねぇ、ひょっとしてなんだけどさ、(.+?)オナニーするとき電マ使ってる？$	응, 혹시이지만 , $1자위할 때 전마 사용하고 있어?
$^はは……うん、そうだね。(.+?)は電マでオナニーなんかしてないんだよね。$	(은)는은……응, 그렇다. $1는 전마로 자위같은 것을 하지 않아.
$^まぶたをギュッと閉じ、(.+?)は羞恥に耐える。おそらく自分がとんでもないことを口走ったことに自覚はあるのだろう。$	눈꺼풀을 군이라고 닫아 $1는 수치에 참는다. 아마 자신이 터무니 없는 것을 말해버렸던 것에 자각은 있는 것일까.
$^その後、(.+?)は俺がいいよというまで顔を真っ赤にしたまま、しっかりと肩をほぐしてくれた。$	그 후, $1는 내가 좋아라고 할 때까지 얼굴을 새빨갛게 한 채로, 제대로 어깨를 풀어 주었다.
$^それじゃ、(.+?)行ってくるね。$	그러면, $1갔다오는군.
$^(.+?)は嬉しそうにうっとりとした表情でこちらを見つめてくる。$	$1는 기쁜듯이 넑을 잃은 표정으로 이쪽을 응시해 온다.
$^(.+?)のことだ。おおよそ中身は和食だろう。$	$1다. 대체로 내용은 일식일 것이다.
$^……これが(.+?)の一部だと思うと怖くて食べられないよ。でも大事に食べさせてもらうよ。$	……이것이 $1의 일부라고 생각하면(자) 무서워서 먹을 수 없어. 그렇지만 소중하게 먹여 주어.
$^あれ……(.+?)、手ケガしてる？$	저것…… $1, 손 상처를 입고 있어?
$^それにしても(.+?)もメイドとしての立ち振る舞いがすっかり板についてきたね。$	그렇다 치더라도 $1도 메이드로서의 행동거지가 완전히 잘 어울려 왔군요.
$^なんだか、最近は(.+?)とずっと一緒にいる気がするよ。$	어쩐지, 최근에는 $1와 쭉 함께 있는 생각이 들어.
$^俺はそう結論付けると(.+?)の待つ、お風呂場へと足を向けた。$	나는 그렇게 결론 붙이면(자) $1가 기다리는, 목욕탕으로 발길을 향했다.
$^(.+?)が、なにやら悲しそうな雰囲気で部屋に入ってくる。$	$1가, 어쩐지 슬픈 것 같은 분위기로 방에 들어 온다.
$^それからしばらく(.+?)は考え込む。$	그리고 당분간 $1는 골똘히 생각한다.
$^あ……え、う、や、やるっていっても(.+?)に……その、無いよね？　その……どうやってやるつもりなの？$	아……네, , 나, 한다 라고 해도 $1에……그, 없지요?　그……어떻게 할 생각이야?
$^(.+?)の有無を言わせない迫力に思わずたじろいでしまう。$	$1의 유무를 말하게 하지 않는 박력에 무심코 뒷걸음질쳐 버린다.
$^(.+?)の普段の優しい笑顔と同じなのに、どこか迫力を帯びたその表情に全身から冷や汗が噴き出る。$	$1의 평상시의 상냥한 웃는 얼굴과 같은데, 어딘가 박력을 띤 그 표정에 전신으로부터 식은 땀이 뿜어 나온다.
$^(.+?)、な、なにをしてるの……？$	$1, , 무엇을 해……?
$^股間を見やれば俺は下半身を露出され(.+?)にいいように弄られていた。$	사타구니를 바라보면 나는 하반신이 노출되고 $1에 좋은 것 같게 만지작거려지고 있었다.
$^(.+?)みたいな可愛い女の子にご奉仕してもらって無表情でいられる男はいないよ。$	$1같은 사랑스러운 여자 아이에게 봉사받아 무표정해 있을 수 있는 남자는 없어.
$^うぅ……あぁ、気持ちいいよ(.+?)。$	……아, 기분이 좋아 $1.
$^ん～、(.+?)？$	응∼, $1?
$^寝ぼけ眼で下半身を見やると(.+?)が俺のペニスを咥え熱心に奉仕していた。$	멍청한 눈으로 하반신을 바라보면(자) $1가 나의 페니스를 질네 열심히 봉사하고 있었다.
$^どうやら、最近(.+?)の中で朝フェラで俺を起こすのが習慣になってきているらしい。$	아무래도, 최근 $1중(안)에서 아침 페라로 나를 일으키는 것이 습관이 되고 있는 것 같다.
$^ここのところ起きると、毎朝(.+?)が俺のペニスを咥えているのだ。$	요즘 일어나면(자), 매일 아침 $1가 나의 페니스를 질네라고 있다.
$^それは……(.+?)の奉仕が上手だからだよ。$	그것은…… $1의 봉사가 능숙하기 때문이다.
$^(.+?)、なんだか怖いよ。それに、この時間が永遠に続くなんて生殺しもいいところだよ。$	$1, 어쩐지 무서워. 게다가, 이 시간이 영원히 계속되다는 반죽임도 좋은 곳이야.
$^すると、(.+?)は一瞬だけきょとんとし意味を理解したのか、その顔をほころばせる。$	그러자(면), $1는 일순간만 멍청히 해 의미를 이해했는지, 그 얼굴을 피기 시작하게 한다.
$^(.+?)……もうっ！$	$1……이제(벌써)!
$^(.+?)、でるよっ！$	$1, 나온다!
$^しかし、(.+?)はイヤな顔ひとつせず、俺の精液を飲み干していってくれる。$	그러나, $1는 싫은 얼굴 하나 하지 않고, 나의 정액을 다 마셔 가 준다.
$^(.+?)凄く気持ちよかったよ。$	$1굉장히 기분 좋았어요.
$^(.+?)をバーカウンターに連れて来てから彼女は始終ニコニコしていた。$	$1를 바 카운터에 데려 오고 나서 그녀는 언제나 싱글벙글 하고 있었다.
$^それにしても(.+?)、今日は凄く機嫌が良さそうだね。ひょっとしていいことでもあった？$	그렇다 치더라도 $1, 오늘은 굉장히 기분이 좋을 것 같다. 혹시 좋은 일이기도 했어?
$^(.+?)は大袈裟だなぁ。$	$1는 과장이구나.
$^これからはもっと(.+?)のことを見ているようにするよ。$	지금부터는 좀 더 $1를 보고 있도록(듯이) 할게.
$^この日、(.+?)は珍しく泥酔していた。$	이 날, $1는 드물게 만취하고 있었다.
$^飲むのを辞めさせようにも、(.+?)にしては珍しく手からお酒を離さなかった。$	마시는 것을 그만두게 하려고 해도, $1으로서는 드물게 손으로부터 술을 떼어 놓지 않았다.
$^それはまさかの提案だった。どうやら(.+?)は本格的に泥酔しているようだ。$	그것은 만약의 제안이었다. 아무래도 $1는 본격적으로 만취하고 있는 것 같다.
$^ちょっと、(.+?)ストップ！　ストップ！！　$	좀, $1스톱!　스톱!　
$^ここでこれ以上(.+?)の口を開かせるのは流石に憚られた。$	여기서 더 이상 $1의 입을 열게 하는 것은 유석에 꺼려졌다.
$^大丈夫だって。(.+?)は日本系のお酒の方がすきなんだったよね？　ワインでよかったの？$	괜찮다고. $1는 일본계의 술이 좋아야 군요?　와인으로 좋았어?
$^まったく(.+?)は良い子だなぁ。どうせなら将来\1みたいな子を嫁に貰いたいよ。$	완전히 $1는 좋은 아이구나. 어차피라면 장래 $1같은 아이를 신부에게 받고 싶어.
$^俺は(.+?)みたいな子をメイドに出来て幸せだと思ってるんだよ。$	나는 $1같은 아이를 메이드에게 되어있고 행복하다고 생각하고 있어.
$^ホント、ホント。(.+?)みたいな子なら嫁にしたっていいくらいだよ。$	진짜, 진짜. $1같은 아이라면 신부로 해도 좋을 정도 야.
$^何かにとりつかれたように一気に捲し立てていた(.+?)は、憑物が落ちたかのように椅子に座った。$	무언가에 사로 잡힌 것처럼 단번에 권 해 세우고 있던 $1는, 사람에게 들린 악마가 떨어졌는지와 같이 의자에 앉았다.
$^付き合ってもないのに、こんなことを言い出すなんて(.+?)、今日はかなり酔ってるな……$	교제하지 않았는데, 이런 일을 말하기 시작하다는 $1, 오늘은 꽤 취하고 있는……
$^(.+?)、もう飲んじゃダメだって。$	$1, 이제(벌써) 마시면 안된다고.
$^その後、泥酔した(.+?)は泥のように眠りに落ちた。$	그 후, 만취한 $1는 진흙과 같이 자에 떨어졌다.
$^それにしても(.+?)がまさか豚料理にあそこまで並々ならぬ情熱を持っているとは思わなかった。$	그렇다 치더라도 $1가 설마 돼지 요리에 저기까지 평범치 않은 정열을 가지고 있다고는 생각하지 않았다.
$^今度、豚料理は(.+?)に担当させようかな？$	이번, 돼지 요리는 $1에 담당시킬까?
$^そう言って(.+?)は俺の手を自らの胸に押し当てる。$	그렇게 말해 $1는 나의 손을 스스로의 가슴에 꽉 누른다.
$^あの……(.+?)？$	그…… $1?
$^……俺も(.+?)のことは好きだけど。$	……나도 $1는 좋아하지만.
$^このままじゃ不味い。(.+?)が感極まって今にも俺を襲ってきそうだ。$	이대로는 맛이 없다. $1가 감극해 당장 나를 덮쳐 나무 그렇다.
$^(.+?)、まって……！$	$1, 기다려……!
$^俺は明確な意思を持って近づいてきた(.+?)の身体を押し戻す。$	나는 명확한 의사를 가지고 가까워져 온 $1의 신체를 되밀어낸다.
$^(.+?)は捨てられた子犬のような瞳でこちらを見つめてくる。$	$1는 버려진 강아지와 같은 눈동자로 이쪽을 응시해 온다.
$^いやいや落ち着いてよ。俺は(.+?)の肌をむやみやたらに人前にさらしたくはないよ。$	아니아니 안정되어. 나는 $1의 피부를 막무가내로 남의 앞에 쬐고 싶지는 않아.
$^(.+?)にしては珍しくため息を零す。$	$1으로서는 드물고 한숨을 흘린다.
$^そんな、二番だなんて……(.+?)は常に俺の一番だから心配しなくていいよ。$	그런, 2번이라니…… $1는 항상 나의 제일이니까 걱정하지 않아 좋아.
$^(.+?)はうっとりとこちらを見つめてくる。$	$1는 넋을 잃고이쪽을 응시해 온다.
$^どうしたの、(.+?)。何か用事でも……ん？　今、旦那様って……。$	왜, $1. 뭔가 용건이라도……응? 지금, 서방님이라고…….
$^(.+?)からの『ご主人様』は、他のメイドとは違う愛らしさがあるし。……ラブリーメイドとして成長したってことかもね。$	$1의 『주인님』은, 다른 메이드와는 다른 사랑스러움이 있고. ……러블리 메이드로서 성장했다고 할 수 있을지도.
$^ははは、(.+?)はラブリーメイドの鏡だね。分かったよ、これからはご主人様って呼んでくれ。$	하하하, $1는 러블리 메이드의 거울이구나. 알았어, 지금부터는 주인님이라고 불러 줘.
$^いや、別に……えっと……そ、それで、(.+?)は舞踏会には行くの？$	아니, 별로……그니까……그, 그래서, $1는 무도회에 가는 거야?
$^い、行くんだ。いや、(.+?)が行きたいなら、オーナーとしては止めるつもりはないんだけど。$	가, 갈 거야, 아니, $1가 가고 싶으면, 오너로서는 멈출 생각은 없지만.
$^そうだね。……ねえ、(.+?)。その……好きだよ。$	맞다. ……저기, $1. 그……좋아해.
$^……今日の仕事は、このへんにしようか。夜も遅いし、その……(.+?)。$	……오늘의 일은, 이쯤으로 할까. 밤도 늦고, 그…… $1.
$^ねえ、(.+?)。今度の休み、時間をもらえるかな？$	저기, $1. 이번에 쉬는 시간을 내 줄 수 있겠어?
$^ちょっと(.+?)に魔法をかけようと思ってね。$	조금 $1에 마법을 걸 생각이야.
$^(.+?)を、俺のシンデレラにしたいんだ。$	$1를, 나의 신데렐라로 하고 싶어.
$^(.+?)は今のままでも十分セクシーだと思うから、徐々に自信をもてるようにすればいいんじゃないかな？$	$1는 지금 그대로도 충분히 섹시하다고 생각하니까, 서서히 자신감을 가질 수 있도록 하면 좋지 않을까?
$^考えすぎだって。自分を磨いているうちに、(.+?)も自分がセクシーメイドだって思えるようになるさ。$	지나치게 생각하더라도. 자신을 갈고 닦는 동안에, $1도 자신이 섹시 메이드란 걸 생각하게 될 것이다.
$^わ、分かった。(.+?)が我慢しきれなくなる前に、呼ぶようにするよ。$	아, 알았어. $1가 참을 수 없게 되기 전에 부르도록 할게.
$^覚悟しておいてよ。(.+?)がエッチすぎて、俺だってもう、止められそうにないから。$	각오해 둬. $1가 너무 음란해서, 나도 이제, 멈출 수 없으니까.
$^(.+?)もイノセントメイドになったことだし、呼び方を変えてみようと思うんだ。$	$1도 이노센트 메이드가 된 것이고, 호칭을 바꿔 보려고 생각한다.
$^違う違う。(.+?)が変えるんじゃなくて、俺が変えるんだよ。$	달라 달라. $1가 바꾸는 게 아니라, 내가 바꿀 거야.
$^……お、おう。なんだい、(.+?)。$	……오, 오우, 뭘까, $1.
$^そっか。(.+?)がそれでいいのなら、それでいいよ。っていうか、元に戻っただけだな。$	그래. $1가 그것으로 좋다면, 그것으로 좋아. 랄까, 원래대로 돌아갔을 뿐이니까.
$^お、俺はまだいいかな～。でも、(.+?)はいいお母さんになりそうだよね。$	나, 나는 아직 괜찮을까∼. 하지만, $1는 좋은 엄마가 될 것 같아.
$^もちろんだよ。(.+?)が望むなら、俺は応えてあげたい。でも、今日は随分積極的だね。$	물론이야. $1가 바란다면, 나는 응해주고 싶어. 그렇지만, 오늘은 상당히 적극적이구나.
$^チャームメイドとして成長した(.+?)は、事ある毎に俺を求めてきていた。$	차밍 메이드로서 성장한 $1는, 사사건건 나를 찾고 있었다.
$^……う、うう。精も根も尽き果てそうだ。まさか、(.+?)があんなに求めてくるなんて。$	……으, 으으, 정기의 끝을 본 것 같아. 설마, $1가 그렇게 요구해 오다니.
$^……ふぅ。これで、少しは回復できたかな……ん？　(.+?)、い、いつからそこに？$	……후우. 이것으로 조금은 회복할 수 있을까……응? $1, 어, 언제부터 거기에?
$^レディーメイドとして磨きをかける為、(.+?)は社交ダンスを自主的に始める。$	레이디 메이드로서 갈고 닦기 위해 , $1는 사교 댄스를 자주적으로 시작했다.
$^俺はそんな(.+?)の練習相手として選ばれ、つい先ほどまで社交ダンスの練習をしていた。$	나는 그런 $1의 연습 상대로서 선택되어 바로 방금 전까지 사교 댄스의 연습을 하고 있었다.
$^俺も舞踏会に出席することがあるかもしれないから、ダンスの練習はしないといけなかったし、丁度良かったよ。それにしても、(.+?)は上手くなったね。$	나도 무도회에 참석해야 할 일이 있을지도 모르니까, 댄스 연습은 해야 할 필요가 있었으니, 마침 좋았네. 그렇다 치더라도, $1는 능숙해졌구나.
$^レディメイドとして十分に誇れると思うよ。それに対して、問題は俺だよ。(.+?)の足を引っ張っちゃってるなぁ。いてて……。$	레이디 메이드로서 충분히 자랑할 수 있다고 생각해. 그에 대해, 문제는 나야. $1의 발목을 잡아 버렸으니, 에고고…….
$^ありがとう。だとしても、(.+?)をもっと耀かせるためには、パートナーの俺が頑張らないとね。$	고마워. 그렇다고 해도, $1를 좀 더 빛나게 하려면, 파트너인 내가 노력해야지.
$^本当のことさ。踊っている時の(.+?)は、見蕩れそうになるくらい綺麗なんだ。$	사실이야. 춤추고 있을 때의 $1는, 넋 놓고 바라만 볼 정도로 아름다워.
$^もっともっと耀いた(.+?)を見たいから、これからも練習をする時は一緒にお願いしてもいいかな？$	더욱 더 빛나는 $1를 보고 싶으니까, 앞으로도 연습을 할 때는 함께 부탁해도 될까?
$^ああ、見つけちゃったか。あれはね、社交ダンスの発表会用の衣装だよ。(.+?)のために用意させたんだ。$	아, 찾아냈구나? 저건 말이지, 사교 댄스의 발표회용 의상이야. $1를 위해서 준비시킨 거야.
$^(.+?)、俺は出会った時から、君のことをお姫様だと思っていたよ？$	$1, 나는 만났을 때로부터, 너를 공주님이라고 생각하고 있었어?
$^さあ、涙は拭いて。幸せな涙は美しいけれど、俺は(.+?)の笑顔が好きなんだ。$	자, 눈물은 닦으라고. 행복한 눈물은 아름답지만, 나는 $1의 웃는 얼굴을 좋아해.
$^俺と(.+?)は会場から引き上げ、二人で感想を言い合っているのだった。$	나와 $1는 회장에서 돌아오면서, 둘이서 감상을 서로 말하고 있는 것이었다.
$^だけどさ、(.+?)にリードされっぱなしだったしなぁ。$	그렇지만 , $1에 리드되고 있을 뿐이었고.
$^あぁ……ノービスメイドである(.+?)の、これからの育成方針をどうしようかなって考えてて。$	아……노비스 메이드인 $1의, 앞으로의 육성 방침을 어떻게 해야할지에 대해 생각하고 있어.
$^穏やかな(.+?)を見て、俺はほっとした。$	온화한 $1를 보고, 나는 안심했다.
$^そうだな。(.+?)の、そういうおおらかさが映えるようなメイドっていうのもいいかもね。$	그렇지. $1의, 그러한 넉넉함이 빛나는 것 같은 메이드라고 하는 것도 좋을지도.
$^ノービスメイドの(.+?)のこと、これからどういう風に育てようかな。$	노비스 메이드인 $1, 지금부터 어떤 식으로 육성해야 할까.
$^少し焦りながらそう言って、俺は(.+?)を見た。$	조금 초조해하면서 그렇게 말하며, 나는 $1를 보았다.
$^どうしたの、(.+?)。頭でも打った？$	무슨 일이야, $1. 머리를 부딪혔어?
$^俺は(.+?)に壁際に追い込まれ、通称『壁ドン』をされた。$	나는 $1에 의해 통칭 『 벽쿵 』을 당했다.
$^え、えっと……(.+?)？　急に、どうしたんだ……？$	그, 그니까…… $1? 갑자기, 어떻게 된 거야……?
$^とりあえず、(.+?)に向かい合い、事情を聞いてみる。$	우선, $1를 마주하여, 사정을 물어본다.
$^まぁ、試してもいいけどね……。(.+?)にされるならなんでも嬉しいよ。$	뭐, 시도해도 괜찮겠지만……. $1로 받을 수 있다면 뭐든지 좋아.
$^俺は(.+?)の言葉を聞きながら、彼女の成長を実感するのだった。$	나는 $1의 말을 들으면서, 그녀의 성장을 실감하는 것이었다.
$^(.+?)に指摘されて気付く……俺は知らないうちに、彼女の方へふらふらと引き寄せられてしまっていたようだった。$	$1에 지적되어 깨닫는……나도 모르는 새, 그녀 쪽으로 흔들흔들 이끌려 버린 것 같았다.
$^あれ？　(.+?)、なにか料理でもするの？$	어? $1, 뭔가 요리라도 하는 거야?
$^鼻歌を歌いながら、無邪気に料理の準備をする(.+?)を眺める。$	콧노래를 부르며, 순진하게 요리의 준비를 하는 $1를 바라본다.
$^(.+?)……？　ど、どうしたの、そんなに泣いて……$	$1……? 왜, 그렇게 울어……
$^そう言いながら、(.+?)は言葉半ばに再び泣き出してしまう。$	그렇게 말하면서, $1는 말 중간에 다시 울어 버렸다.
$^（……そういうことか。(.+?)はイノセンスメイド……感受性が豊かなんだな）$	(……그런 것인가. $1는 이노센트 메이드……감수성이 풍부하구나)
$^いいよ、(.+?)。思いきり泣くといい。$	좋아, $1. 맘껏 울어도 돼.
$^俺はそう言って、(.+?)が泣き止むまでずっとそばにいるのだった。$	나는 그렇게 말하며, $1가 우는 것을 그칠 때까지 쭉 곁에 있는 것이었다.
$^いや、そういう意味じゃないよ。……そんな風にね、無邪気な(.+?)のことが好きだなぁって、改めて思って。$	아니, 그러한 의미가 아니야. ……그런 식이네, 순진한 $1가 좋다고, 재차 생각해.
$^(.+?)はそう言いながら、無邪気に幸せな将来に思いを馳せるのだった。$	$1는 그렇게 말하면서, 순진하게 행복한 장래에 희망을 거는 것이었다.
$^(.+?)は、なにやらこそこそと周辺に人目がないか、しきりに確認していた。$	$1은 어쩐지 슬금슬금 주변에 보는 눈이 없는지 자꾸 확인하고 있었다.
$^俺が怪訝に感じていると、(.+?)は急に俺に抱きついてきた。$	내가 의아스럽게 느끼고 있자, $1는 갑자기 나를 껴안았다.
$^あ、あの……急にどうしたの、(.+?)。$	아, 그……갑자기 왜, $1.
$^無邪気に微笑む(.+?)の様子に、堪らず俺もドキドキしてしまう。$	순진하게 미소짓는 $1의 모습에, 참지 못하고 나도 두근두근 해 버린다.
$^(.+?)って、最近すごく可愛くなったよね。$	$1는, 최근 몹시 사랑스러워졌지.
$^いやいや、(.+?)の努力の賜物だよ。……でもさ、他の男に声掛けられらりとかしない？$	아니아니, $1의 노력 덕분이야. ……그렇지만, 다른 남자에게 말을 건다거나 하지 않아?
$^可愛らしくも妖艶に、(.+?)は艶やかに俺を見たのだった。$	사랑스럽고도 요염하게, $1는 요염하게 나를 바라보았다.
$^最近の(.+?)って、すごく魅力的だよね。$	최근의 $1는, 몹시 매력적이지.
$^愛らしく照れて微笑む(.+?)の姿に、俺は図らずもムラムラしてしまう。$	사랑스럽게 수줍어 미소짓는 $1의 모습에, 나는 뜻밖에 불끈불끈 해 버린다.
$^それはもちろん……その……(.+?)、だよ。$	그것은 물론……그…… $1, 야.
$^っ(.+?)！　世界一可愛いよ！$	$1! 세계에서 제일로 사랑스러워!
$^（……以前の(.+?)なら今の言葉でずいぶんと浮かれそうなものなのに……）$	(……이전의 $1라면 지금 말로 대단히 들떴을 텐데……)
$^洗練された(.+?)の立ち居振る舞いに、俺は見惚れるのだった。$	세련된 $1의 행동거지에, 나는 넋을 잃고 보는 것이었다.
$^あれ、コーヒー淹れてるんだ、(.+?)。良い香りだね。$	어라, 커피를 마시고 있구나, $1. 향이 좋네.
$^いやぁ、(.+?)もすっかり立派なメイドさんになったなぁ。俺は誇らしいよ。$	아니, $1도 정말로 훌륭한 메이드가 되었구나. 나는 자랑스러워.
$^最近の(.+?)を見てると、俺も背筋が伸びる思いだよ。\1が俺のメイドで、本当に嬉しい。$	최근의 $1를 보고 있으면, 나도 등근육이 성장하는 느낌이야. $1가 나의 메이드여서, 정말 기뻐.
$^そう言いながら、(.+?)が俺を見る。$	그렇게 말하면서, $1가 나를 본다.
$^えっ……？　(.+?)、ど、どっかに行っちゃうの……！？$	어……? $1, 어, 어디로 가는 거……!?
$^甘やかすように、(.+?)が俺にキスをした。$	응석부리듯이, $1가 나에게 키스를 했다.
$^そのままキスを繰り返す俺と(.+?)だった。$	그대로 키스를 반복하는 나와 $1였다.
$^(.+?)が怒りながら涙ぐんでいる。$	$1가 화내면서 울먹이고 있다.
$^ついさっき、棚から落ちて来た段ボールから(.+?)を守るため、身を挺した結果、俺がちょっとした怪我をしてしまったせいだった。$	바로 조금 전, 선반에서 떨어지는 골판지로부터 $1를 지키기 위해, 몸을 던진 결과, 내가 약간 다쳐버린 탓이었다.
$^近くのファーストフードでさ、新作のシェイクを買ってきたんだけど……(.+?)、感想聞かせてよ。$	근처 패스트푸드점에서, 신작 셰이크를 사 왔는데…… $1, 감상을 부탁하지.
$^そう言って、俺は(.+?)にシェイクを手渡した。$	그렇게 말하고서, 나는 $1에게 셰이크를 주었다.
$^うん。それで、(.+?)もどうかなって思って。$	응. 그래서, $1도 어떨까 하고 생각해.
$^俺は、(.+?)から差し出された書類を受け取る。$	나는, $1가 내민 서류를 받는다.
$^んっ……あ、れ……？　(.+?)……どうしたの、朝から……$	응……어,라……? $1……뭐 하는 거야, 아침부터……
$^よく眠れたけど、ふあっ……寝起きで(.+?)を見ることになるとは思わなかった、んぅ、ううっ……$	잘 잤는데, 후앗……자다 일어나서 $1를 보게 될 줄은 생각 못 했네, 응, 우우……
$^あぁ、ありがとう、(.+?)。$	아, 고마워, $1.
$^(.+?)にビシっと注意されて、俺は若干肩を落とした。$	$1에 변태라고 주의를 받아서, 나는 약간 낙담했다.
$^(.+?)、すっごくよかったよ$	$1, 대단히 좋았어.
$^ん……(.+?)……？$	응……$1……?
$^(.+?)……その、飲み過ぎじゃない……？$	$1……그, 너무 많이 마신 거 아냐……?
$^そ、そう？　(.+?)がそう言うならいいんだけど……$	그, 그래? $1가 그렇게 말한다면 괜찮지만……
$^うーん、そ、そうだよ！　(.+?)がこれ以上酔うなら、全力でエッチな事しちゃうぞ。だから……$	응, 그, 그래! $1가 더 이상 취한다면, 전력으로 음란한 일 해 버릴거야. 그러니까……
$^(.+?)、大丈夫？　少し休もうか？$	$1, 괜찮아? 조금 쉴까?
$^大丈夫、(.+?)？　水でも飲む？$	괜찮아, $1? 물이라도 마실래?
$^うん、可愛い。それに、(.+?)みたいな女の子だと、余計にそう感じるね。$	응, 귀여워. 게다가, $1같은 여자라면, 더 그렇게 느껴지네.
$^ん？　大丈夫、(.+?)？$	응? 괜찮아, $1?
$^うーん……。(.+?)さ、少し飲み過ぎてないかな？$	응……. $1, 조금 과음한게 아닐까?
$^それは嬉しいな。(.+?)にそんな風に言ってもらえると、もっと頑張れる気がしてくるよ。$	그것은 기쁜데. $1에 그런 식으로 들을 수 있으면, 좀 더 노력할 수 있겠단 생각이 들어.
$^あはは、(.+?)って酔っ払うとそんな感じになるんだね……$	아하하, $1는 몹시 취하면 그런 기분이 드는 거구나……
$^俺も幸せだよ、(.+?)。$	나도 행복해, $1.
$^いつまでも続いて欲しいっていうのは確かだけど、なんていうか、(.+?)と一緒に時間を重ねたい、みたいな。$	언제까지나 계속되었으면 좋다고 말하는 것은 확실하지만, 뭐라고 할까, $1와 함께 시간을 쌓아가고 싶다, 같은.
$^変わらない永遠より、(.+?)との一瞬を生きていたい。$	변함없는 영원보다, $1와의 순간을 살고 싶다.
$^ふふ……可愛い(.+?)。$	후후……귀여운 $1.
$^(.+?)……あまり細かい事は言いたくないんだけど、お酒、飲み過ぎじゃないかな？$	$1……너무 세세한 일은 말하고 싶지 않지만, 술, 과음이 아닐까?
$^(.+?)……もちろん、好きだよ。決まってるじゃないか。$	$1……물론, 좋아해. 정해져있는이 아닌가.
$^ドアを開け(.+?)が部屋に入ってくる。$	문을 열고 $1가 방에 들어온다.
$^(.+?)はさくらちゃんに押し倒されている俺を見て驚いた声を上げる。$	$1는 사쿠라에게 밀어 넘어뜨려지고 있는 나를 보고 놀라 소리를 높였다.
$^(.+?)、こ、これはえっと……$	$1, 이, 이건 그러니까……
$^そんなの(.+?)じゃなくてもビックリしてしまう。$	그런 건 $1가 아니어도 깜짝 놀라 버려.
$^しかし、(.+?)の反応はそれだけでは収まらない。$	그러나, $1의 반응은 그것만으로는 가라앉지 않는다.
$^(.+?)、落着いて話そうよ……$	$1, 침착하게 말할게……
$^(.+?)は納得できない様子で、俺の顔をじっと見る。$	$1는 납득할 수 없는 모습으로, 나의 얼굴을 가만히 본다.
$^(.+?)、どうかした？$	$1, 무슨일이야?
$^(.+?)、ど、どうかした？$	$1, 어, 어쩌다가?
$^(.+?)が怒りで肩を震わせる。$	$1가 분노로 어깨를 떤다.
$^(.+?)の視線が俺に刺さる。$	$1의 시선이 나에 꽂힌다.
$^(.+?)のじとっと視線が俺に刺さる。$	$1의 불쾌해 보이는 시선이 나에게 박힌다.
$^(.+?)が勢いよくさくらちゃんを指さす。$	$1가 힘차게 사쿠라쨩을 가리키다.
$^(.+?)がさくらちゃんに向き直る。$	$1가 사쿠라쨩으로 방향을 바꾼다.
$^(.+?)が意を決したようにさくらちゃんに話しかける$	$1가 뜻을 결정한 것처럼 사쿠라에게 말을 걸었다.
$^(.+?)が氷すらも凍てつくような瞳でさくらちゃんに話しかける。$	$1가 얼음조차 얼려버릴 것 같은 눈동자로 사쿠라쨩에게 말을 건넨다.
$^こうして、何故か(.+?)とさくらちゃんがメイドバトルを行うことになった。$	이렇게 해서, 왠지 $1와 사쿠라쨩이 메이드 배틀을 벌이게 됐다.
$^バトルまでに(.+?)の誤解が解ければいいけど……$	배틀이 시작되기 전까지 $1의 오해가 풀리면 좋겠는데……
$^(.+?)とさくらちゃんの戦いは終わった――。$	$1와 사쿠라쨩의 싸움은 끝났다――.
$^勝ったのは(.+?)だった。$	이긴 것은 $1였다.
$^しかし、戦い終了直後に(.+?)の誤解は解けた。$	그러나, 싸움이 끝난 직후 $1의 오해는 풀렸다.
$^なんでも、これから(.+?)が館内を案内して回ることになったのだという。$	어쨌든, 이제부터 $1가 관내를 안내해주면서 돌아다니기로 한 것 같다.
$^(.+?)の話によると、品評会なるものが催しとして行われるみたいだ。$	$1의 이야기에 의하면, 품평회 되는 것이 행사로서 행해지는 것 같다.
$^俺が品評会について聞いてみると、(.+?)は首を傾げる。$	내가 품평회에 대해 들어 보면, $1는 고개를 갸웃한다.
$^(.+?)に聞いてみても、詳しい情報は無いみたいだった。$	$1에게 들어 봐도, 자세한 정보는 없는 것 같았다.
$^部屋で作業していると、(.+?)が俺に品評会が開催される事を伝えてくれた。$	방에서 작업하고 있으면(자), $1가 나에게 품평회가 개최되는 일을 전해 주었다.
$^ふぅん……(.+?)達の普段の努力を評価してくれる場所、か。$	응…… $1들의 평상시의 노력을 평가해 주는 장소, 인가.
$^テストみたいなものか、(.+?)ならきっと優秀な結果を残せると思うよ。$	테스트같은 것인가, $1라면 반드시 우수한 결과를 남길 수 있다고 생각해.
$^はぁ、はぁ……。(.+?)は綺麗だね……。$	후~, 하아……. $1는 예쁘다…….
$^(.+?)が魅力的なのが悪いんだよ？$	$1가 매력적인 것이 나빠?
$^はは、それならそうかもね。……(.+?)、いつも見てるんだ？$	는은, 그렇다면 그럴지도. ……$1, 언제나 보고 있지?
$^はいはい。じゃあ、たまにはこういう格好もしてくれる？　(.+?)だけを見るから、ね？$	네네. 그러면, 가끔 씩은 이런 모습도 해 주어? $1만을 보니, 까요?
$^何かあっても、そんな格好で泥酔してた(.+?)が悪いんだからね？$	뭔가 있어도, 그런 모습으로 만취하고 있었던$1이 나쁘기 때문에?
$^そんな格好で泥酔した(.+?)に、何もしないと思う？　まあでも責任は取るから、(.+?)は気にせず泥酔してよ。$	그런 모습으로 만취한$1에, 아무것도 하지 않는다고 생각해? 뭐 그렇지만 책임을 지기 때문에, $1는 신경쓰지 않고 만취해요.
$^え？　そんなの決まってるじゃないか。エッチな格好の(.+?)だよ……お酒が進むなぁ。$	네? 그런 것 정해져 있지 않은가. 엣치한 모습의$1야…… 술이 진행되는구나.
$^ぷいっと少し赤く染まった顔をそむける(.+?)を見ながら、俺は酒を楽しむ。$	휙 조금 붉게 물든 얼굴을 돌리는$1을 보면서, 나는 술을 즐긴다.
$^なんだかお客様の視線が(.+?)に集中している気がする。$	어쩐지 고객의 시선이$1에 집중하고 있을 생각이 든다.
$^そうなんだけどね。でも(.+?)は俺のメイドで、お客様のものじゃないんだけどな……。$	그렇지만 말야. 그렇지만$1은 나의 메이드로, 고객의 것이 아니지만…….
$^あ、照れた？　照れる(.+?)もいいねー。$	아, 수줍었어? 수줍은$1도 좋다―.
$^それはの(.+?)の汗だよ。それに、震えてる。やっぱり緊張してたみたいだね。$	그것은의 $1의 땀이야. 게다가, 떨리고 있다. 역시 긴장하고 있던 것 같다.
$^お世辞じゃない。(.+?)は可愛い。これはただの事実だから。$	겉치레말이 아니다. $1는 사랑스럽다. 이것은 단순한 사실이니까.
$^自信がないからパス。(.+?)の勝ちでいいよ。$	자신이 없기 때문에 패스. $1의 승리로 좋아.
$^俺は絶対に負けられないけど、(.+?)の酒量が分からないからね。$	나는 절대로 질 수 없지만, $1의 주량이 모르기 때문에.
$^俺が酔い潰れたせいで、(.+?)の評価にマイナスをつけたくないし。$	내가 취해 무너진 탓으로, $1의 평가에 마이너스를 붙이고 싶지 않고.
$^(.+?)らしいけど、俺以外のお客様にあんまりそういう態度はやめておいたほうが。$	$1인것 같지만, 나 이외의 고객에게 너무 그러한 태도는 그만두는 편이.
$^俺は表裏のない人間だよ。(.+?)を可愛いと言ったのは本心だから。$	나는 표리가 없는 인간이야. $1를 사랑스럽다고 말한 것은 본심이니까.
$^だって俺は男だからね。(.+?)みたいな可愛い子とエッチ出来る機会は逃したくない。$	왜냐하면 나는 남자니까. $1같은 사랑스러운 아이와 엣치할 수 있을 기회는 놓치고 싶지 않다.
$^だけど今は、まずは(.+?)を一人前にしたいから……かな。$	그렇지만 지금은, 우선은$1을 한 사람 분으로 하고 싶기 때문에…… 일까.
$^実際、そうだからね。この世界での、(.+?)の価値が高まるんだ。$	실제, 그러니까. 이 세계에서의, $1의 가치가 높아진다.
$^(.+?)だって、思うところがあってこの世界に入ってきたんだろ？$	$1도, 생각하는 곳이 있어 이 세계에 들어 온 것일 것이다?
$^真面目だよ。時間だって惜しい。でも、(.+?)には必要だと思ったんだ。$	성실해. 시간이라도 아깝다. 그렇지만, $1에는 필요하다고 생각한 것이다.
$^だって、(.+?)から楽しい提案が出るって思ってたからね。$	왜냐하면, $1로부터 즐거운 제안이 나온다 라고 생각하고 있었기 때문에.
$^(.+?)はもっと実用的な本を読んでいるイメージがあってさ。$	$1는 좀 더 실용적인 책을 읽고 있는 이미지가 있어 말야.
$^まあ、マンガっていっても、お色気たっぷりの青年マンガだから、(.+?)とは好みが合わないだろうけど。$	뭐, 만화라고 해도, 색기 충분한 청년 만화이니까, $1와는 취향이 맞지 않겠지만.
$^勉強になるのに。でも確かに、まだ(.+?)には見て欲しくないかな。$	공부가 되는데. 그렇지만 확실히, 아직$1에는 보기를 원하지 않을까.
$^今(.+?)がＡＶを見たら、女優の艶技を覚えてしまうからね。だから、まだ見て欲しくない。$	지금$1이 AV를 보면, 여배우의 염 기술을 기억해 버리니까요. 그러니까, 아직 보기를 원하지 않다.
$^いや、あれはあれで、乗り慣れると色々と刺激が……(.+?)？　もしかして、本当に怒ってる？$	아니, 저것은 저것대로, 타 익숙해지면 다양하게 자극이……$1? 혹시, 정말로 화내고 있어?
$^(.+?)、好きな動物はいる？$	$1, 좋아하는 동물은 있어?
$^なるほど、(.+?)は動物に忠実さを求めているんだね。$	과연, $1는 동물에 충실함을 요구하고 있는 것이군.
$^そうだね。……というか(.+?)、普通に猫好きなんじゃないか？$	그렇다. …… 그렇다고 할까$1, 보통으로 고양이를 좋아하는 것이 아닌가?
$^え、俺が犬になるの？　俺はご主人様のはずなんだけど……その場合、(.+?)はどうなるんだ？$	네, 내가 개가 되는 거야? 나는 주인 같을 것이지만…… 그 경우, $1는 어떻게 되지?
$^(.+?)の好きな科目とか授業ってある？$	$1가 좋아하는 과목이라든지 수업은 있어?
$^なるほどね。なんか(.+?)らしいな。$	과연. 뭔가$1인것 같은데.
$^いつも(.+?)が頑張って仕事してくれて助かってるよ。$	언제나$1가 노력해 일해 주어 살아나고 있다.
$^だね。(.+?)との意外な共通点を見つけたね。$	(이)구나. $1와의 뜻밖의 공통점을 찾아냈군요.
$^え？　なになに、どうしたの急に……(.+?)、なんだか剣呑な雰囲気に。$	네? 뭐뭐, 무슨 일이야 갑자기……$1, 뭔가 위험한 분위기에.
$^そっか、(.+?)らしいね。$	그래, $1인것 같다.
$^いやいや、メイドのみんなが大変そうなのは俺も嫌だし。(.+?)だってそうでしょ？$	아니아니, 메이드의 모두가 대단한 것은 나도 싫고. $1라도 그렇겠지?
$^はは。でも(.+?)も夏のそういうところがいいんじゃないの？$	는은. 그렇지만$1도 여름의 그러한 곳이 좋은 것이 아닌거야?
$^そうかぁ。でも俺は一回でいいから(.+?)の浴衣姿も見てみたいよ。きっと似合うんだろうなぁ。$	그런가. 그렇지만 나는 1회로 좋으니까$1의 유카타 모습도 보고 싶어. 반드시 어울릴 것이다.
$^はは、そうだね。(.+?)の好きなものは、俺も好きでいたいからね。$	는은, 그렇네. $1가 좋아하는 것은, 나도 좋아하고 있고 싶으니까.
$^まぁ、俺はお肉より(.+?)のほうが好きってことで。$	아무튼, 나는 고기보다$1쪽이 좋아한다는 것으로.
$^そうだ。(.+?)の恋愛感を教えてよ。$	그렇다. $1의 연애감을 가르쳐요.
$^ああ、うん。納得した。とても、(.+?)らしいね。$	아, 응. 납득했다. 매우, $1인것 같다.
$^できるんじゃないかな？　(.+?)ならきっとお客様を楽しませるような事ができると思うよ。$	할 수 있는 것이 아닐까? $1라면 반드시 고객을 즐겁게 하는 것 같은 일이 생긴다고 생각한다.
$^まあ、まだ見ぬご主人様のことを考えるよりも、(.+?)は自分を磨くことだね。$	뭐, 아직 보지 않는 주인님의 일을 생각하는 것보다도, $1는 자신을 닦는 것이구나.
$^ちなみに俺は、(.+?)が恋人なら大歓迎だよ。$	덧붙여서 나는, $1가 연인이라면 대환영이야.
$^(.+?)は、休日どんな風に過ごしてる？$	$1는, 휴일 어떤 식으로 보내고 있어?
$^(.+?)なら、どんな服でも似合いそうなもんだけど。$	$1라면, 어떤 옷이라도 어울릴 것 같은 것이지만.
$^そうか。となると、(.+?)は食べ物がいいって事だ。$	그런가. 그렇게 되면, $1는 음식이 좋다는 일이다.
$^なるほどなぁ。(.+?)はその辺り、しっかり切り分けて考えてるんだね。$	과연. $1는 그 근처, 확실히 분리하고 생각하고 있는 것이군.
$^(.+?)の為に使いたい。$	$1를 위해서(때문에) 사용하고 싶다.
$^そうそう、(.+?)は俺のメイドなんだし。別に、おかしい事じゃないだろ？$	그렇게 자주, $1는 나의 메이드인거고. 별로, 이상한 일이 아닐 것이다?
$^そりゃそうだよ。というか、どうして(.+?)だけ呼ばないシチュエーションがあるんだ？$	그것은 그래. 라고 할까, 어째서$1만 부르지 않는 시추에이션이 있지?
$^そういうのをたかるって言うんだよ、(.+?)……。$	그러한 것을 모여든다 라고 말하는거야, $1…….
$^いやいや、自腹で行ってくれ。(.+?)。カジノにはあまり興味がないし。$	아니아니, 자기부담으로 가 줘. $1. 카지노에는 그다지 흥미가 없고.
$^そういえばそうだったね。まあ、(.+?)がアメリカに行きたいっていうのは伝わったけど。$	그렇게 말하면 그랬지. 뭐, $1가 미국에 가고 싶다고 말하는 것은 전해졌지만.
$^いや、ちょっとね。別に、(.+?)に似合わないってわけじゃないよ。$	아니, 조금. 별로, $1에 어울리지 않는다는 것이 아니야.
$^そうだろ？　ほら、(.+?)だってそう思うんじゃないか。$	그렇겠지? 이봐요, $1라도 그렇게 생각하는 것이 아닌가.
$^馬に乗ってる(.+?)も、絵になるんだろうなぁ。$	말을 타고 있는$1도, 그림이 될 것이다.
$^(.+?)の乗馬みたいに、夢中になれるものがあったらいいんだけどね。$	$1의 승마같이, 열중할 수 있는 것이 있으면 좋지만 말야.
$^はは、性にあってるのかな。(.+?)はどう？　メイドさん、楽しい？$	는은, 성에 있고 있는 것일까. $1는 어때? 가정부, 즐거워?
$^(.+?)はさ、血液型って信じる？$	$1는, 혈액형은 믿어?
$^はは。(.+?)に対しては、特にエッチかもね。可愛いから。$	는은. $1에 대해서는, 특히 엣치할지도. 사랑스러우니까.
$^はは。でも(.+?)が辛い目にあうよりは、いいかなって。$	는은. 그렇지만$1이 괴로운 꼴을 당하는 것보다는, 좋을까 하고.
$^じゃあ半分こにしよう。俺も(.+?)のこと、放ってはおけないよ。$	그러면 반 와로 하자. 나도$1의 일, 발해 둘 수 없어.
$^(.+?)の得意料理って何かな？$	$1의 자신있는 요리라는건 무엇이지?
$^いや、そのままのほうが(.+?)らしくていいと思うよ。$	아니, 그대로의 편이$1인것 같고 좋다고 생각한다.
$^俺も、(.+?)の手料理なら、色々食べてみたいな。$	나도, $1의 손요리라면, 여러가지 먹어 보고 싶은.
$^料理は愛情、だと思うからさ。(.+?)も楽しんでやったほうがいいよ。$	요리는 애정, 이라고 생각할테니까. $1도 즐겨 주는 편이 좋아.
$^はは。まぁ(.+?)が嫌なら、別に構わないよ。$	는은. 아무튼$1이 싫으면, 별로 상관없어.
$^違うって。(.+?)が可愛すぎるからいけないんだよ。$	다르다고. $1가 너무 사랑스럽기 때문에 안 돼.
$^それはやっぱり、(.+?)だからね。エッチも好きになるよ。$	그것은 역시, $1니까. 엣치도 좋아하게 된다.
$^エッチもだけど、今もね。(.+?)と過ごせたら、俺はそれで楽しいんだよ。$	엣치도이지만, 지금도 말야. $1와 보낼 수 있으면, 나는 그래서 즐거워.
$^本当に、(.+?)が可愛いからさ。$	정말로, $1가 사랑스럽기 때문에.
$^それはそうかもしれないけどさ。出来れば(.+?)にも積極的になって欲しいっていうか。$	그것은 그럴지도 모르지만 말야. 할 수 있으면$1에도 적극적으로 되었으면 좋다고 말할까.
$^(.+?)って情熱的なんだね。$	$1는 정열적인 것이구나.
$^(.+?)は\1でいいんだよ？$	$1는 $1대로 좋아?
$^(.+?)は喋らなかったら可愛いのにね。$	$1는 말하지 않았으면 사랑스러운데.
$^わ、(.+?)、気が早いね……。そんなに急がなくてもいいんじゃないかな。$	원, $1, 성질이 급하다……. 그렇게 서두르지 않아도 괜찮은 것이 아닐까.
$^大丈夫だよ。俺を信じてよ、(.+?)。$	괜찮아. 나를 믿어요, $1.
$^だから(.+?)は、焦らないでも大丈夫だよ。$	그러니까$1는, 초조해 하지 않아도 괜찮아.
$^いいや、別に構わないよ。俺も、(.+?)のいろんな表情が見られて嬉しい。$	좋아, 별로 상관없어. 나도, $1의 여러가지 표정을 볼 수 있어 기쁘다.
$^(.+?)の気持ちはわかってる。ずっとそばにいてほしい。$	$1의 기분은 알고 있다. 쭉 곁에 있으면 좋겠다.
$^ありがとう。(.+?)が一緒にいてくれるってだけで、俺も元気が出てくるんだ。$	고마워요. $1가 함께 있어 준다 라고만으로, 나도 기운이 생겨 온다.
$^(.+?)、大胆だな。そこまでストレートな言葉が返ってくるとは思わなかったよ。$	$1, 대담하다. 거기까지 스트레이트한 말이 되돌아 온다고는 생각하지 않았어요.
$^いや、そんな事はないよ。そう言ってもらえるのは嬉しいよ、(.+?)。$	아니, 그런 일은 없어. 그렇게 말해 받을 수 있는 것은 기뻐, $1.
$^(.+?)は大げさだな。$	$1는 과장되다.
$^でも、(.+?)がしたいっていうなら、毎日でも……。$	그렇지만, $1를 하고 싶다고 말한다면, 매일이라도…….
$^ああ、当たり前だろ。(.+?)みたいな魅力的な女の子を前にして、我慢なんかできるわけないじゃないか。$	아, 당연할 것이다. $1같은 매력적인 여자 아이를 앞에 두고, 인내 따위 할 수 있을 이유 없지 않은가.
$^なに、(.+?)は何か心配していたの？$	뭐, $1는 뭔가 걱정하고 있었어?
$^杞憂だよ、それは。(.+?)としない日なんて、俺には考えられないよ。$	기우야, 그것은. $1로 하지 않는 날이라니, 나에게는 생각할 수 없어.
$^おぉ、(.+?)、なんだか恰好良いね。すごい、自信満々だ。$	$1, 왠지 근사하다. 굉장해, 자신만만하다.
$^そこまで想われるなんて、嬉しいよ、(.+?)。$	거기까지 생각해지다니 기뻐, $1.
$^いや、正直言うとかなりドキドキしてる……。やっぱり、(.+?)には敵わないな。$	아니, 솔직히 말하면 꽤 두근두근 하고 있다……. 역시, $1에는 이길 수 없구나.
$^いやいや、違う、(.+?)は今、誤解してるよ。$	아니아니, 다른, $1는 지금, 오해하고 있다.
$^だから、その……要は、俺は何があっても(.+?)の事が好きだって、そう言いたかったんだよ。$	그러니까, 그…… 요점은, 나는 무엇이 있어도$1의 일을 좋아한다고, 그렇게 말하고 싶었던 것이야.
$^ああ、もちろんだよ。俺が(.+?)を裏切る事なんて、あり得ないからさ。$	아, 물론이야. 내가$1를 배반하는 일이라니, 있을 수 없기 때문에.
$^うん。何があっても、(.+?)のそばにいるよ。$	응. 무엇이 있어도, $1의 곁에 있어.
$^そんな(.+?)の顔、見てみたいかも。$	그런$1의 얼굴, 보고 싶을지도.
$^いや、(.+?)に不満なんてあるわけないよ、当たり前じゃないか。$	아니, $1에 불만은 있을 이유 없어, 당연하지 않은가.
$^でもさ、(.+?)と常に一緒にいられるわけじゃないだろ？　だから、あの本は必要なもので……$	그렇지만, $1와 항상 함께 있을 수 있는 것이 아닐 것이다? 그러니까, 그 책은 필요한 것으로……
$^(.+?)だって、もし勝手に自分の物を捨てられたらイヤだろ？$	$1도, 만약 마음대로 자신의 물건을 버려지면 싫겠지?
$^……うぅん、わかったよ、(.+?)。今回は俺が悪かった。$	…… 우응, 알았어, $1. 이번은 내가 나빴다.
$^……わかった。俺には(.+?)だけだ。$	…… 알았다. 나에게는$1뿐이다.
$^ああ、必要ない。(.+?)がいてくれるんだ、これ以上望むものはないよ。$	아, 필요없다. $1가 있어 준다, 더 이상 바라는 것은 없어.
$^ありがとう、(.+?)。でも、\1が全部してくれるのか……楽しみだな。$	고마워요, $1. 그렇지만, $1가 전부 해 주는지…… 기다려진다.
$^別に誤魔化してなんかいないさ。それに、俺には(.+?)がいるからこそ、むしろこういう本が必要なんだよ。$	따로 속인 적 따위 없는 거야. 게다가, 나에게는$1이 있기 때문이야말로, 오히려 이런 책이 필요해.
$^だから俺は、後学のためエロ本を買うんだ。それは(.+?)の為にもなるからね。$	그러니까 나는, 후학이기 때문에 에로책을 산다. 그것은$1을 위해서(때문에)도 되니까요.
$^へえ、(.+?)、ずいぶん強気じゃないか。本当にここでもいいの？$	에 네, $1, 대단히 강하지 않은가. 정말로 여기에서도 좋은거야?
$^じゃあここで、俺の要求に全部応えてくれるんだ……(.+?)、すごいね。$	잡어개로, 나의 요구에 전부 응해 준다……$1, 굉장하다.
$^(.+?)がそこまで覚悟を持っているなんて、知らなかったけど。さすが、俺のメイドだな。$	$1가 거기까지 각오를 가지고 있다니 몰랐지만. 과연, 나의 메이드다.
$^へえ……(.+?)、今日はなかなか言うもんだね。それなら、俺としても考えがあるよ。$	에……$1, 오늘은 꽤 말하는 것이구나. 그렇다면, 나로서도 생각이 있어.
$^まぁ、それはそうなんだけど。まさか(.+?)がそこまで乗り気になるとは思ってなかったから。$	아무튼, 그것은 그렇지만. 설마$1가 거기까지 내켜하는 마음이 된다고는 생각하지 않았으니까.
$^ああ、本気だ。(.+?)がその気になってるのに、俺が尻込みしてちゃ駄目だからな。$	아, 진심이다. $1가 그럴 기분이 들고 있는데, 내가 주저해 하고 있어서는 안되기 때문에.
$^このお酒を飲み終わったら、人払いして……(.+?)に、『何でも』してもらおうかな$	이 술을 다 마셨으면, 주위 사람을 없게 함 해……$1에, 『뭐든지』해 받을까
$^ふふ、楽しみだな。(.+?)のいろんな姿がこの場で見られるのか……$	후후, 기다려진다. $1의 여러가지 모습이 이 장소에서 볼 수 있는 것인가……
$^いくら(.+?)でも、人目があったら、さすがにね……$	아무리$1라도, 남의 안목이 있으면, 과연……
$^いや、(.+?)の事は好きだよ。好きに決まってるじゃないか。$	아니, $1의 일은 좋아해. 좋아하게 정해져 있지 않은가.
$^(.+?)は、そんなにエッチな事がしたいの？$	$1는, 그렇게 엣치한 일을 하고 싶은거야?
$^(.+?)はなにか、好きな乗り物とかはあるかな。$	$1는 뭔가, 좋아하는 탈 것이라든지는 있을까나.
$^本当？　それなら(.+?)の水着姿が見れそうだな。$	사실? 그렇다면$1의 수영복 모습을 볼 수 있을 것 같다.
$^それは楽しみだな。(.+?)とリゾートか、考えるだけでもわくわくするよ。$	그것은 기다려진다. $1와 리조트인가, 생각하는 것만이라도 두근두근 한다.
$^いやいや、(.+?)に無理はさせられないよ。$	아니아니, $1에 무리는 시킬 수 없어.
$^大胆だね、(.+?)。お酒飲みながら抱きしめたら、我慢できなくなっちゃうよ。$	대담하다, $1. 술 마시면서 껴안으면, 인내 할 수 없게 되어 버린다.
$^(.+?)が大丈夫でも、俺が大丈夫じゃないよ。$	$1가 괜찮아도, 내가 괜찮지 않아.
$^……うん、まあね。(.+?)にその気にさせられる仕草を見せられたら、そうなっちゃうかもね。$	…… 응, 글쎄. $1에 그런 기분이 들게 할 수 있는 행동을 보여지면, 그렇게 되어 버릴지도 몰라.
$^いやいや違う、そういう意味じゃないよ。グッとくる仕草を、(.+?)が聞いてきたんじゃないか。$	아니아니 다르다, 그러한 의미가 아니야. 훨씬 오는 행동을, $1가 (들)물었지 않은가.
$^嬉しい提案だけど、さりげなくされるのがいいんじゃないか、(.+?)。$	기쁜 제안이지만, 자연스럽게 되는 것이 좋은 것이 아닌지, $1.
$^ああ、そうだな。(.+?)が思う以上に効果的だと思うよ。$	아, 그렇다. $1가 생각하는 이상으로 효과적이라고 생각한다.
$^え？　(.+?)、洗濯物の匂いを嗅いだの？　どうして？$	네? $1, 세탁물의 냄새를 맡았어? 어째서?
$^魔が差すのは仕方がないとしても、まさか実際に行動に移すとは……。(.+?)、行動的だね。$	먼가에 씌이는 것은 어쩔 수 없다고 해도, 설마 실제로 행동으로 옮긴다고는……. $1, 행동적이다.
$^俺は別にいいけどさ……。(.+?)の事が心配になるよ。$	나는 별로 좋지만 말야……. $1의 일이 걱정으로 된다.
$^やっぱりそういう考えがあったのか……。(.+?)は油断ならないな。$	역시 그러한 생각이 있었는가……. $1는 방심할 수 없구나.
$^(.+?)って、エッチなメイドだよな。こんなところで、そんな話するなんて。$	$1는, 엣치한 메이드구나. 이런 곳에서, 그런 이야기하다니.
$^うぅ、わ、わかってるよ……。(.+?)をそんな風にしたのは俺だよ。……これでいいだろ？$	아, 알고 있다……. $1를 그런 식으로 한 것은 나야. …… 이것으로 좋을 것이다?
$^ま、まあそりゃね……。でも大丈夫だよ、(.+?)。一回くらいなら、別に気にしないでも。$	뭐, 뭐 그렇다면……. 그렇지만 괜찮아, $1. 1회 정도라면, 별로 신경쓰지 않아도.
$^俺も、(.+?)のこと考えながら寝てるよ。$	나도, $1의 일 생각하면서 자고 있다.
$^はは、俺の夢にも(.+?)が出てくるよ。$	는은, 나의 꿈에도$1가 나온다.
$^はは、たしかに。(.+?)に触れるんだから、現実のほうがいいかな。$	는은, 분명히. $1에 접하기 때문에, 현실 쪽이 좋을까.
$^(.+?)のこと、どんどん可愛く見えてくるんだよ。明日になったらもっと可愛いんだろうなぁ。$	$1의 일, 자꾸자꾸 사랑스럽게 보여 오는거야. 내일이 되면 좀 더 사랑스러울 것이다.
$^はは、俺も(.+?)になら責められてみたいかな。$	는은, 나도$1에라면 꾸짖을 수 있어 보고 싶은가.
$^え？　どうだろう、(.+?)だからかな？$	네? 어떨까, $1이니까일까?
$^そんなことないよ、(.+?)は最初からずっと可愛かったよ。$	그렇지 않아, $1는 최초부터 훨씬 사랑스러웠어요.
$^本当だって！　好き、大好き、(.+?)のこと愛してる。一生離れたくないよ。$	사실이라고! 좋아해, 너무 좋아, $1의 일 사랑하고 있다. 일생 떨어지고 싶지 않아.
$^でも俺が可愛いって思ったんだから、(.+?)は可愛い。これは間違いないよ。$	그렇지만 내가 사랑스럽다고 생각한 것이니까, $1는 사랑스럽다. 이것은 틀림없어.
$^それより俺は？　(.+?)は、最初から俺のこと格好いいと思ってた？$	그것보다 나는? $1는, 최초부터 나의 일 멋지다고 생각하고 있었어?
$^(.+?)はさくらんぼのヘタを口の中で結ぶの、やったことある？$	$1는 체리의 열매 꼭지를 입 안에서 묶는 것, 한 적 있어?
$^俺も、さくらんぼより(.+?)がいいなぁ。$	나도, 체리보다$1가 좋은데.
$^じゃあ(.+?)は、俺がモテたら嫌？$	자$1는, 내가 인기있으면 싫어?
$^するわけないよ。俺は(.+?)とキスできれば満足なんだから。$	할 이유 없어. 나는$1과 키스 할 수 있으면 만족하기 때문에.
$^はは、(.+?)は可愛いなぁ。$	는은, $1는 사랑스러운데.
$^ごめんごめん。でも本当に、今すぐ(.+?)にキスしたくなったよ。$	미안 미안. 그렇지만 정말로, 금방$1에 키스 하고 싶어졌어.
$^そっか、(.+?)が嫌ならやめておくよ。$	그래, $1가 싫으면 그만둔다.
$^ほら、ちゃんと聞こえるように言ってみて、(.+?)$	이봐요, 제대로 들리도록(듯이) 말해 봐, $1
$^恥じらう(.+?)も可愛いね。$	부끄러워하는$1도 사랑스럽다.
$^ふーん、(.+?)がそう言う態度を取るんなら、少し俺にも考えがあるよ？$	음.. $1가 그렇게 말하는 태도를 취한다면, 조금 나에게도 생각이 있어?
$^……きっとみんな大注目してくれるね。(.+?)、綺麗だしね。$	…… 반드시 모두대주목해 주네요. $1, 예쁘니까.
$^ん？　(.+?)。どうかした？$	응? $1. 어떻게든 했어?
$^強いて言うなら、(.+?)みたいなメイドが側に居たら、かもね？$	억지로 말한다면, $1같은 메이드가 곁에 있으면, 일지도?
$^いや、俺は(.+?)と話したいから。$	아니, 나는 $1이라고 이야기하고 싶으니까.
$^(.+?)と話したいからね、緊張してるヒマなんてないよ。$	$1라고 이야기하고 싶으니까, 긴장하고 있는 짬 같은거 없어.
$^はは、どういたしまして。でも、俺が(.+?)に興味あるだけだからさ。$	는은, 천만에요. 그렇지만, 내가 $1에 흥미 있을 뿐(만큼)이니까.
$^はは、それだけじゃないけどね。(.+?)はどう？　俺に興味はない？$	는은, 그것뿐이 아니지만 말야. $1는 어때? 나에게 흥미는 없어?
$^いいよ。ゆっくり、(.+?)らしくしてればそれで。$	좋아. 천천히, $1인것 같게 하고 있으면 그것으로.
$^(.+?)は、お酒はどれぐらい飲めるの？$	$1는, 술은 어느 정도 마실 수 있는 거야?
$^それにもう、(.+?)はちゃんと出来てるんじゃない？$	거기에 이제(벌써), $1는 잘 나오고 와 있는 것이 아니야?
$^いやいや、いいよ全然。素直に思ったことを言ったほうが、(.+?)らしいと思うな。$	아니아니, 좋아 전혀. 솔직하게 생각한 것을 말하는 편이, $1인것 같다고 생각하는구나.
$^でも(.+?)は、一緒にいると落ち着けるっていうか……そういう魅力があると思うから。$	그렇지만$1은, 함께 있으면 안정시킨다 라고 할까…… 그러한 매력이 있다고 생각하기 때문에.
$^間違いないよ。(.+?)は魅力的だって、俺が保証する。$	틀림없어. $1는 매력적도, 내가 보증한다.
$^まぁ(.+?)も、そのうち楽しめるようになるんじゃないかなぁ。$	아무튼 $1도, 그 중 즐길 수 있게 되는 것이 아닐까.
$^もちろん。(.+?)だって、なにも感じないわけじゃないでしょ？$	물론. $1도, 아무것도 느끼지 않을 것이 아니지요?
$^でも俺は(.+?)のこと、可愛いと思ってる。だから、俺にはあるんだよ。$	그렇지만 나는$1의 일, 사랑스럽다고 생각하고 있다. 그러니까, 나에게는 있는거야.
$^慣れてくれば、(.+?)も気持ちよくなるよ。$	익숙해져 준다면, $1도 기분 좋아진다.
$^(.+?)ってどんな本が好きなのかな？$	$1는 어떤 책을 좋아하는 것일까?
$^え！？　あ、いや、それって(.+?)じゃなくて読書する人に失礼なのでは……？$	네!? 아, 아니, 그 거$1가 아니고 독서하는 사람에게 실례인 것은……?
$^えっと、話を戻すけれど……(.+?)ってどんな本が好き？$	어라고 이야기를 되돌리지만……$1는 어떤 책을 좋아해?
$^(.+?)の好きな音楽は？$	$1가 좋아하는 음악은?
$^(.+?)の好きなＴＶ番組はなに？$	$1가 좋아하는 TV프로그램은 뭐?
$^(.+?)もだんだん俺のことがわかってきたね。$	$1도 점점 나의 일이 알게 되었군요.
$^(.+?)は、好きなスポーツって何かある？$	$1는, 좋아하는 스포츠라는거 뭔가 있어?
$^……いや、(.+?)も結構変わってると思うけどね。$	…… 아니, $1도 상당히 변한다고 생각하지만 말야.
$^それとも(.+?)、俺のスポーツに付き合ってくれる？$	그렇지 않으면$1, 나의 스포츠에 교제해 줄래?
$^気まぐれか。(.+?)も、なんだかそういうところがあるよね。$	변덕스러운가. $1도, 뭔가 그러한 곳이 있네요.
$^そ、そうか。そりゃあ猫好きの(.+?)には負けるかもしれないな……$	그런가. 그렇다면 고양이 좋아하는$1에는 질지도 모르는구나……
$^じゃあ(.+?)も、悪い人じゃないわけだね。俺も、ご主人様として嬉しいよ。$	자$1도, 나쁜 사람이 아닌 것이구나. 나도, 주인님으로서 기뻐.
$^(.+?)はさ、好きだった科目とか授業ってある？$	$1는, 좋아했던 과목이라든지 수업은 있어?
$^へえ、そうなんだ。なんだか(.+?)らしいな。$	에 네, 그렇다. 뭔가$1인것 같은데.
$^(.+?)が理数系っぽいって話。別に、文科系が苦手って事ではないけどさ。$	$1가 이수계 같다는 이야기. 별로, 문과계에 약하다는 일은 아니지만 말야.
$^だよね。の感じが、(.+?)っぽいなと思って。$	(이)지요. 의 느낌이, $1같다라고 생각해.
$^あ、でも(.+?)がそういうのを楽しみにしてるの、なんか意外だな。$	아, 그렇지만$1이 그러한 것을 기대하고 있는 것, 뭔가 의외이다.
$^確かにね。それに、食べ物だけじゃなくて、(.+?)の言う通り雪やイルミネーションも綺麗だ。$	확실히. 게다가, 음식 뿐이 아니고, $1가 말하는 대로눈이나 일루미네이션도 예쁘다.
$^うん、(.+?)、なんだかすごく楽しそうだ。表情はあんまり変わっていないけど。$	응, $1, 뭔가 굉장히 즐거운 듯 하다. 표정은 너무 변함없지만.
$^い、言ったけど……あれ、もしかして(.+?)、あまり夏は好きじゃない、かな……？$	있고, 말했지만…… 저것, 혹시$1, 그다지 여름은 좋아하지 않는다, 일까……?
$^(.+?)って、何か好きな食べ物はあるかな。$	$1는, 뭔가 좋아하는 음식은 있을까나.
$^今こうやって(.+?)と一緒だと、お酒が美味しくなって、どんどん飲んじゃうけどね。$	지금 이렇게 해$1와 함께라고, 술이 맛있어져, 자꾸자꾸 마셔 버리지만 말야.
$^うん。(.+?)にも楽しくなってもらえるように、頑張るよ。$	응. $1에도 즐거워져 받을 수 있도록(듯이), 노력한다.
$^あれ、その時って(.+?)がサンドイッチとかおにぎり作るの？$	저것, 그 때는$1이 샌드위치라든지 주먹밥 만드는 거야?
$^良いなぁ、(.+?)の手作りサンドイッチとかおにぎりとか……。俺も食べてみたいな。$	좋다, $1의 손수 만든 샌드위치라든지 주먹밥이라든지……. 나도 먹어 보고 싶은.
$^いやいや、レトルトカレーもカップラーメンも、すごく美味しいよ。(.+?)はあまり食べないの？$	아니아니, 리토르트 카레도 컵라면도, 굉장히 맛있어. $1는 그다지 먹지 않는거야?
$^今日はさ……(.+?)の恋愛観を教えてほしいんだけど。$	오늘은……$1의 연애관을 가르치기를 원하지만.
$^いや、そんな事はないと思うよ。(.+?)は綺麗だし、可愛いじゃないか。$	아니, 그런 일은 없다고 생각한다. $1는 예쁘고, 사랑스럽지 않은가.
$^嘘でも冗談でもお世辞でもないよ。……それで、さっきの話の続きだけど、(.+?)の恋愛観を教えてほしいんだ。$	거짓말에서도 농담도 겉치레말도 아니야. …… 그래서, 조금 전의 이야기의 계속이지만, $1의 연애관을 가르치기를 원한다.
$^ああ、そうなんだ。(.+?)、すごく可愛いじゃないか。$	아, 그렇다. $1, 굉장히 사랑스럽지 않은가.
$^そうかもしれないね、って話だよ。だって、(.+?)は素敵なメイドだからね。$	그럴지도 모른다, 라는 이야기야. 그렇지만, $1는 멋진 메이드니까.
$^(.+?)の休日の過ごし方は？　いつもどうしてる？$	$1의 휴일의 생활 방법은? 언제나 어떻게 하고 있어?
$^違ったか……(.+?)が恥ずかしいところって言うからさ。$	달랐는지……$1가 부끄러운 곳이라고 말할테니까.
$^ねぇ、(.+?)。もし宝くじが当たったらどうする？$	응, $1. 만약 복권이 당첨되면 어떻게 해?
$^立派だね。それに俺は(.+?)のこと大切に想ってるから、もう半分は叶っちゃってるね。$	훌륭하다. 거기에 나는$1의 일 소중히 생각하고 있기 때문에, 이제(벌써) 반은 실현되어 버리고 있네요.
$^なら、(.+?)は可愛いから、道を歩けば声を掛けられるんじゃない？$	라면, $1는 사랑스럽기 때문에, 길을 걸으면 말을 걸려지는 것이 아니야?
$^はは、(.+?)なら絵になりそうだね。$	는은, $1라면 그림이 될 것 같네.
$^えっ？　俺も愛してるよ、(.+?)。$	어? 나도 사랑하고 있다, $1.
$^(.+?)みたいな可愛い女の子に言われたら、みんなドキッとするんじゃないかな。$	$1같은 사랑스러운 여자 아이에게 들으면, 모두 두근 하는 것이 아닐까.
$^そっか、よかったよ。俺が言うのもなんだけど、やっぱり(.+?)はクールなほうが素敵だからさ。$	그래, 좋았어요. 내가 말하는 것도 뭐 하지만, 역시$1는 쿨한 편이 멋지기 때문에.
$^俺には、(.+?)みたいな落ち着きが欲しいよ。$	나에게는, $1같은 침착성을 갖고 싶어.
$^はは、でも(.+?)と話すの、俺は楽しいよ。$	는은, 그렇지만$1이라고 이야기하는 것, 나는 즐거워.
$^えっ？　今の(.+?)かぁ……$	어? 지금의$1인가……
$^はは、(.+?)も案外、普通の女の子ってことだと思うよ。$	는은, $1도 의외로, 보통 여자 아이라는 것이라고 생각한다.
$^みんなも、だんだんわかってくるよ。(.+?)の……味？　っていうものがさ。$	모두도, 점점 알게 된다. $1의…… 맛? 라고 하는 것이 말야.
$^上手く言えないけど、自分のことを可愛くないと思っちゃってる、(.+?)が可愛いと思うんだよ。$	능숙하게 말할 수 없지만, 자신의 일을 사랑스럽지 않다고 생각해 버리고 있다, $1가 사랑스럽다고 생각하는거야.
$^はは、(.+?)らしいね。$	는은, $1인것 같다.
$^ごめんごめん。でもそういうことを気にする(.+?)は可愛いよ。不器用だけど、真面目なんだなってわかる。$	미안 미안. 그렇지만 그런 일을 신경쓰는$1은 사랑스러워. 서투르지만, 성실한 것이구나 하고 안다.
$^それは困るよ！　(.+?)が男だったら、エッチ出来なくなっちゃう！$	그것은 곤란하다! $1가 남자라면, 엣치할 수 없게 되어 버린다!
$^いや、その、男だとしても(.+?)のことは好きだけど、たぶん……さすがにエッチはちょっと……$	아니, 그, 남자라고 해도$1의 일은 좋아하지만, 아마…… 과연 엣치는 조금……
$^……うん、すごく冷静だね。(.+?)を驚かせようと思ったら、とりあえずこれらは無意味ってわけだ。$	…… 응, 굉장히 냉정하다. $1를 놀래키려고 생각하면, 우선 이것들은 무의미하다는 것이다.
$^いや、(.+?)の驚く様子はさぞ可愛いだろうなって思ったから。$	아니, $1가 놀라는 모습은 필시 사랑스러울거라고 생각했기 때문에.
$^(.+?)はいつも淡々としてるから……怖がったりするのかなって。$	$1는 언제나 담담하고 있기 때문에…… 무서워하거나 하는 것일까 하고.
$^そうみたいだね。(.+?)の怖いものってなに？$	그런 것 같네. $1의 무서운 것은 뭐?
$^いや、(.+?)が度胸があるんだよ。$	아니, $1가 담력이 있는거야.
$^(.+?)が作ってくれるなら嬉しいよ。楽しみにしてるね。$	$1가 만들어 준다면 기뻐. 기대하고 있네요.
$^ふふ、楽しみだな。(.+?)のご飯なんて、想像するだけで嬉しくなっちゃうな。$	후후, 기다려진다. $1의 밥이라니, 상상하는 것만으로 기뻐져 버리는군.
$^仕方がないじゃないか。(.+?)を前にしてお酒を飲んでるんだから、こうなっても仕方ないと思う。$	어쩔 수 없지 않은가. $1를 앞에 두고 술을 마시고 있기 때문에, 이렇게 되어도 어쩔 수 없다고 생각한다.
$^ありがとう。俺も好きだよ、(.+?)のこと。$	고마워요. 나도 좋아해, $1의 일.
$^もう俺はさ、(.+?)がいないと生きていけないんだよ。$	이제(벌써) 나는, $1가 없으면 살아갈 수 없어.
$^ご、ごめん、ほんの冗談だよ。引っかかるとは思わなくて！　もちろん俺は(.+?)のこと愛してるよ？$	미안, 그저 농담이야. 걸린다고는 생각하지 않아서! 물론 나는$1의 일 사랑하고 있어?
$^本当にごめんね、(.+?)。俺がバカだったんだ。$	정말로 미안해요, $1. 내가 바보였던 것이다.
$^そうかな、俺は(.+?)の色々な表情を知っているつもりだけれど……$	그럴까, 나는$1의 다양한 표정을 알고 있을 생각이지만……
$^ご、ごめんって！　(.+?)、\1が一番だよ！$	미안은! $1, $1가 제일이야!
$^俺は(.+?)から求められたら、嬉しいけどなぁ。$	나는$1으로부터 요구되면, 기쁘지만.
$^もちろん、俺は(.+?)の恋人だからね。$	물론, 나는$1의 연인이니까.
$^積極的な(.+?)もいいなぁ。試しにおねだりしてみてくれない？$	적극적인$1도 좋은데. 시험삼아 졸라대 봐 주지 않겠어?
$^うん。俺は(.+?)とならいつだってエッチしたいよ。今もね。$	응. 나는$1와라면 언제라도 엣치하고 싶어. 지금도 말야.
$^し、したくなったら、俺が(.+?)のところに行くから！$	하, 하고 싶어지면, 내가$1에 가기 때문에!
$^(.+?)はさ、もし俺に他に好きな人ができたらどうする？$	$1는, 만약 나에게 그 밖에 좋아하는 사람이 생기면 어떻게 해?
$^安心して、大丈夫だよ。俺には(.+?)しかいないんだから。$	안심해, 괜찮아. 나에게는 $1밖에 없기 때문에.
$^それだけ(.+?)のことが好きってことだよ。$	그 만큼$1의 일을 좋아한다는 것이야.
$^それでも、いやなものはいやだ。(.+?)を渡すつもりはないよ。$	그런데도, 싫은 것은 싫다. $1를 건네줄 생각은 없어.
$^当然、っていうかもう(.+?)がいないとダメなんだよ、俺は。$	당연, 라고 말할지도 $1가 없으면 안되어, 나는.
$^大丈夫だよ、俺は(.+?)のことが好きなんだから。\1は、そうじゃない？$	괜찮아, 나는 $1의 일을 좋아하는 것이니까. $1는, 그렇지 않아?
$^まぁ、俺には(.+?)っていう恋人がいるから、嫌だっていうなら仕方ないね。$	아무튼, 나에게는$1이라고 하는 연인이 있기 때문에, 싫라고 말한다면 어쩔 수 없다.
$^本当に？　(.+?)、積極的に応えてくれるんだね。嬉しいな。$	정말로? $1, 적극적으로 응해 주는 것이군. 기쁜데.
$^あはは、お酒を飲んでると、ついね。それに相手が(.+?)だと、張り切っちゃってさ。$	아하하, 술을 마시고 있으면, 무심코. 거기에 상대가 $1라고, 의욕에 넘쳐 버려 말야.
$^そうだね。結局その方が、安心してできるよね。(.+?)は俺のメイドなんだから、独り占めしたいしね。$	그렇다. 결국 그 쪽이, 안심하고 할 수 있네요. $1는 나의 메이드인 것이니까, 독점하고 싶기도 하고.
$^お酒を飲んだまま、周りの人に見られて……そのまま(.+?)の身体を好きにできたら、すごく興奮するよね。$	술을 마신 채로, 주위의 사람에게 보여져…… 그대로 $1의 신체를 마음대로 할 수 있으면, 굉장히 흥분하네요.
$^もちろんだよ。相手が(.+?)なんだからね、興奮しない方がどうかしてる。$	물론이야. 상대가 $1니까, 흥분하지 않는 것이 어떻게든 하고 있다.
$^あぁ、それもそうだね。ごめん、(.+?)。$	아, 그것도 그렇다. 미안, $1.
$^全体的に、普通にやる感じだけど……(.+?)は平気？$	전체적으로, 보통으로 하는 느낌이지만……$1는 괜찮아?
$^でも、それを言うなら、(.+?)だって血管が出ているところが好きって言ったじゃないか。それと同じ事じゃない？$	그렇지만, 그것을 말한다면, $1도 혈관이 나와 있는 곳이 좋아한다고 말했지 않은가. 그것과 같은 일이 아니야?
$^はは、そうだね。(.+?)の仕事をする仕草も綺麗で好きだな。$	는은, 그렇네. $1의 일을 하는 행동도 예쁘고 좋아한다.
$^引くわけないよ、(.+?)。確かに少し驚いたけど……それだけ、俺の事を気に掛けてくれてるって事でしょ？$	당길 이유 없어, $1. 확실히 조금 놀랐지만…… 그것 뿐, 나의 일을 걱정해 주고 있다는 일이겠지?
$^いや、俺も、(.+?)のベッドで寝たいって思った。$	아니, 나도, $1의 침대에서 자고 싶다고 생각했다.
$^イヤかな？　でも(.+?)だって俺のベッドを使ったわけだし、俺も\1のベッドを使いたいなぁ。$	싫은가? 그렇지만$1도 나의 침대를 사용한 것이고, 나도 $1의 침대를 사용하고 싶은데.
$^なるわけないよ。俺は(.+?)の事が大好きなんだからさ。$	될 이유 없어. 나는$1의 일을 아주 좋아한 것이니까.
$^ふふ、(.+?)のベッドで何しようかなぁ。なんだかドキドキしてきちゃうな。$	후후, $1의 침대에서 어떻게 할까나. 뭔가 두근두근 해 와 버리는군.
$^そうしてくれた方が、助かるかな。……でも、思っていたより(.+?)がエッチだったな。$	그렇게 해 준 (분)편이, 살아날까나. …… 그렇지만, 생각하고 있었던 것보다$1가 엣치했던.
$^へえ、(.+?)は夜伽がないと、気持ちを持て余してるんだね。$	에 네, $1는 밤시중이 없으면 기분을 주체 못하고 있는 것이군.
$^そう？　でも(.+?)、どんなプレイを想像して、一人で悶々としてるの？$	그렇게? 그렇지만$1, 어떤 플레이를 상상해, 혼자서 번민스럽게 하고 있는 거야?
$^教えてくれたら、次から夜伽がない時、(.+?)がなに考えてるか想像できるからさ。$	가르쳐 주면, 다음으로부터 밤시중이 없을 때, $1가 뭐 생각하고 있을까 상상할 수 있을테니까.
$^そうかなぁ。(.+?)は、気にならないの？$	그럴까. $1는, 신경이 쓰이지 않는거야?
$^(.+?)の事以外、考える事なんてないよ。$	$1의 일 이외, 생각하는 일 같은거 없어.
$^(.+?)が今なにをしてるのかなぁとか、もう眠っちゃったのかなぁ……とか。考えるだけでドキドキするよね。$	$1가 지금 무엇을 하고 있는지라든지, 벌써 자 버렸던가…… 라든지. 생각하는 것만으로 두근두근 하네요.
$^本当の事言ってるだけだよ。イヤだった？　(.+?)。$	사실 말하고 있을 뿐(만큼)이야. 싫었어? $1.
$^じゃあいいじゃないか、(.+?)。$	그러면 좋지 않은가, $1.
$^……大好きな(.+?)にはっきり言われると、なんだか照れるなぁ。$	…… 정말 좋아하는$1에 분명히 말해지면, 뭔가 수줍은구나.
$^いやぁ、(.+?)の反応好きだからさ。可愛い声、いっぱい聞きたいんだよね。$	아니, $1의 반응을 좋아하기 때문에. 사랑스러운 소리, 가득 (듣)묻고 싶네요.
$^(.+?)にされるなら、俺も嬉しいよ。夜伽、楽しみにしてるね。$	$1로 된다면, 나도 기뻐. 밤시중, 기대하고 있네요.
$^(.+?)は練習熱心だな。そんなに俺との夜伽が好きなの？$	$1는 연습 열심이다. 그렇게 나와의 밤시중을 좋아해?
$^それは嬉しいよ。今度、(.+?)の口を味わいたいな。$	그것은 기뻐. 이번, $1의 입을 맛보고 싶은데.
$^(.+?)の良いところいっぱい知ってるのに、これ以上見せる気なの？$	$1가 좋은 곳 가득 알고 있는데, 더 이상 보일 생각이야?
$^そっか。それじゃ、その内見せてよ、(.+?)。$	그래. 그러면, 그 안 보여요, $1.
$^あれ？　(.+?)、なんだか興奮してる？$	어? $1, 뭔가 흥분하고 있어?
$^エッチなメイドだね、(.+?)は。こんなところで発情するなんてさ……$	엣치한 메이드구나, $1는. 이런 곳에서 발정한다니 말야……
$^やめない。あ、向こうのお客様も(.+?)に興味津々みたいだよ？$	그만 안 해. 아, 저기 있는 손님도 $1에게 흥미진진한 것 같은데?
$^うーん、恥じらう(.+?)を肴に飲むお酒は美味しいなぁ。$	으음, 부끄러워하는 $1를 안주 삼아서 마시는 술은 맛있네.
$^いいじゃないか。(.+?)の体は見られてもおかしくないくらい綺麗だよ。$	좋잖아. $1의 몸매는 보여져도 이상하지 않을 정도 예쁜데.
$^だからいいんじゃないか。俺の(.+?)はこんなに綺麗なんだって自慢できるし。$	그래서 좋잖아. 나의 $1는 이렇게 예쁘다고 자랑할 수 있고.
$^あれ？　(.+?)、お酒が進んでないね？$	어라? $1, 술을 안 마시고 있네?
$^もしかしたら、(.+?)の身体も触られちゃうかもね……$	혹시, $1의 몸을 만져버릴지도 몰라……
$^ほら(.+?)、堂々としないと。$	이봐 $1, 당당해야지.
$^いいじゃないか。(.+?)が注目されて、俺は嬉しいよ。$	좋잖아. $1가 주목받아서, 나는 기뻐.
$^(.+?)をみんなに自慢したいって事だよ。例えば(.+?)にすごくイケメンの彼氏がいて、その彼氏に視線が集まったら、どう？$	$1를 모두에게 자랑하고 싶다는 거야. 예를 들면 $1에게 엄청 미남인 남자친구가 있고, 그 남자친구에게 시선이 모아지면 어때?
$^(.+?)が肝硬変とかなったらすっごく俺は悲しいし。$	$1가 간 경화 같은 거에 걸리면 난 너무 슬플 거야.
$^……何か思い詰めてない、(.+?)？$	…… 뭔가 심각하게 생각하는 거 아냐, $1?
$^俺は(.+?)がいいんだ。$	나는 $1가 좋은 거야.
$^(.+?)はどんなジャンルの本が好きなんだ？$	$1는 어떤 장르의 책을 좋아해?
$^あと(.+?)が好きそうなものって持ってたかなぁ。$	그런데 $1가 좋아할 만한 걸 갖고 있으려나.
$^あははっ、そうかなあ？　(.+?)もアニソン聴いたりするの？$	아하핫, 그런가? $1도 애니송을 듣거나 해?
$^(.+?)は、好きなテレビ番組はあるのかな？$	$1는 좋아하는 TV 프로그램 있어?
$^(.+?)の好きなスポーツってなにかな。$	$1가 좋아하는 스포츠는 뭐야.
$^ほら、(.+?)、レオタードとか似合いそうだしさっ。$	이봐, $1, 레오타드 같은 거 어울릴 것 같고 말야. (레오타드 : 발레, 에어로빅 등에서 입는 무용복)
$^(.+?)はどんな動物が好きなのかな。$	$1는 어떤 동물을 좋아하려나.
$^(.+?)の好きな科目ってなんだったの？$	$1가 좋아하는 과목은 뭐였어?
$^どっちもかな。(.+?)は「薔薇」って書ける？$	둘 다일까. $1는 「薔薇 (장미)」라고 쓸 수 있어? 
$^(.+?)の好きな季節は、春夏秋冬でどれかな？$	$1가 좋아하는 계절은 봄, 여름, 가을, 겨울 중에 뭐야?
$^そうだな……(.+?)の言う通りだね。ごめんなさい。$	그렇네……$1가 말하는 대로네. 미안해요.
$^(.+?)も浴衣に合うと思うよ、きっと似合うっ！$	$1도 유카타에 맞을 거라고 생각해, 분명 어울려!
$^(.+?)は好きな食べ物ってある？$	$1는 좋아하는 음식 있어?
$^いやっ！　いやいやっ！　(.+?)のいってることは正しいよっ！$	아니! 아니 아니! $1가 말하고 있는 건 맞아!
$^いやいやっ、(.+?)は正しいよっ！$	아니 아니, $1가 맞아!
$^いや、そうかなぁ……(.+?)なら大歓迎だと思うんだけど……$	아니, 아닐 걸……$1라면 대환영이라고 생각하는데……
$^まぁねぇ。(.+?)らしいなって。$	뭐, 그렇네. $1답구나 해서.
$^むしろ(.+?)を貰いたい。$	오히려 $1를 받고 싶어.
$^(.+?)、頭いいなぁっ！$	$1, 머리 좋네!
$^(.+?)とどっぷり湯に浸かって、ゴシゴシ洗って貰って。$	$1와 뜨거운 물에 몸을 담그고, 쓱쓱 씻겨 주는.
$^(.+?)は優しくて綺麗で、可愛いなぁ……$	$1는 착하고 예쁘고, 사랑스럽네……
$^でも、(.+?)はよくやってくれているよ。$	그래도, $1는 잘 해 주고 있어.
$^(.+?)って服のことになると熱くなるんだね。$	$1는 옷에 관한 일이 되면 뜨거워지는구나.
$^(.+?)に逢うときは鏡でチェックしてから、って。$	$1를 만날 때는 거울로 체크하니까 말야.
$^このエンパイアクラブに(.+?)がいなかったら……$	이 엠파이어 클럽에 $1가 없었으면……
$^(.+?)ってさ、幽霊とか、ホラー映画は恐いと思う？$	$1는 말야, 유령이나, 호러 영화를 무섭다고 생각해?
$^部屋に戻って独りになって、あぁ、ここには(.+?)がいないんだって思うとね。$	방에 돌아가서 혼자서 되고, 아아, 여기에는 $1가 없구나 하고 생각하면 말야.
$^(.+?)の得意な料理ってなにかな？$	$1가 자신있는 요리는 뭐야?
$^ところでさ、(.+?)的にはこういうのってどうなのかな？$	그런데 말야, $1 개인적으로는 이런 거 어때?
$^(.+?)が乗り気だったらしたいけど、我慢するぐらいだったらいいかな……？$	$1가 내켜서 한다면 하고 싶은데, 참을 정도라면 됐으려나……?
$^俺だけ気持ちよくなって、(.+?)は置いてけぼりだしな。$	나만 기분 좋아져서, $1는 놓고 갈 거야.
$^いや、その。ありがとう、俺も(.+?)のこと大好きだよ。$	아니, 그. 고마워, 나도 $1를 정말 좋아해.
$^(.+?)に嫌われたらやだなぁ、って思うことがあるって言おうと思ったんだ。$	$1에게 미움받기 싫다고 생각한 적이 있다고 말하려고 했어.
$^(.+?)は結婚とかしたいかな？$	$1는 결혼 같은 거 하고 싶어?
$^いや、(.+?)ならいいお嫁さんになると思うけどなっ。$	아니, $1라면 좋은 신부가 될 거라고 생각하는데.
$^俺がいいたいのは、(.+?)が普通に恋に落ちて幸せな結婚をして……$	내가 말하고 싶은 건, $1가 평범하게 사랑에 빠지고 행복한 결혼을 해서……
$^そうだ、命令か……！　(.+?)、結婚してくれ。$	그래, 명령인가……! $1, 결혼해 줘.
$^そんなことないよぉ。そうだ、俺も、これからは(.+?)のことを観察しながらエッチするっ！$	그렇지 않아. 그렇네, 나도 지금부터는 $1를 관찰하면서 섹스할래!
$^どこが弱いかとか、(.+?)を逐一見つつエッチする。$	어디가 약하다거나, $1를 일일이 살펴 보면서 섹스할래.
$^(.+?)が真面目にエッチになると、身体持たないかも俺。$	$1가 성실하게 야하게 되면, 몸이 남아나지 않을지도, 나.
$^待って(.+?)っ、独りで空想して落ち込まないでくれっ。$	기다려 $1, 혼자 공상해서 낙담하지 말아 줘.
$^そこじゃなくて、俺が(.+?)の以外の子に乗り換えるとか、ありえないし。$	거기가 아니고, 내가 $1가 아닌 다른 아이로 갈아탈 일은 없어.
$^あのさ、俺の部屋のエロ本がないんだけど。(.+?)は知らない？$	저기 말야, 내 방에 야한책이 없는데. $1는 몰라?
$^(.+?)が処分したのか……そうだよね、ごめん。$	$1가 처분했구나…… 그렇네, 미안.
$^もし俺が(.+?)の立場だったら、いやーな気分になるもんな。$	만약 내가 $1의 입장이라도, 싫은 기분이 될 거야.
$^そうだ、名案が浮かんだ！　(.+?)を撮ろうっ！$	맞다, 명안이 떠올랐다! $1를 찍자!
$^(.+?)はどうなの？$	$1는 어떤데?
$^そっかぁ、(.+?)らしいな。いつか一緒に行こう。$	그래, $1답네. 언젠가 같이 가자.
$^再確認するけど(.+?)は俺のことどう思ってる？$	다시 확인하는데, $1는 나를 어떻게 생각해?
$^そのままでいいんだよ、(.+?)のありのままで。$	그대로도 좋아, $1의 있는 그대로.
$^(.+?)の匂い。$	$1의 냄새.
$^ああ、いいにおいだな、(.+?)って……$	아아, 좋은 냄새네, $1는……
$^迷惑だなんて、(.+?)からの電話ならいつでもオッケーだよ。$	실례라니, $1의 전화라면 언제든지 OK야.
$^(.+?)は変態だなぁ。$	$1는 변태구나.
$^充分(.+?)はキスが上手だと思うけどなぁ。$	$1는 충분히 키스를 잘한다고 생각하는데 말야.
$^(.+?)？　なにがあったんだ！？$	$1? 왜 그래!?
$^そう言いつつも、俺の要望通りの格好で来てくれる(.+?)が好きだよ。$	그러면서도, 나의 요망대로 꼴로 오는 $1가 좋아.
$^ふふっ……それにしても、いい眺めだね。(.+?)の女性らしさが前面に押し出されてて、ついつい股間が反応しちゃいそうだよ。$	후훗....그것만 해도 좋은 전망이야. $1여성 다움이 앞세우고 있어서, 바로 고간이 반응할 지경이야.
$^ほら、周りをよく見てごらん。何人かのお客様が(.+?)を見てにやにやしているじゃないか。$	이봐요, 주위를 잘 보렴. 몇몇 손님이 $1을 보고 히죽거리고 있잖아.
$^(.+?)は股間を擦り合わせるようにもじもじする。$	$1은 사타구니를 비볐다도록 머뭇거린다.
$^(.+?)ってエッチな格好で外を歩く趣味とかないの？$	$1은 야한 옷차림으로 밖을 걷는 취미같은건 없어?
$^俺は(.+?)と話ができて嬉しいよ。$	나는 $1와 이야기를 할 수 있어 기뻐.
$^(.+?)がかわいいからだよ。$	$1가 귀엽기 때문이다.
$^俺は(.+?)が傍にいてくれるだけで楽しいよ。$	나는 $1가 옆에 있어 주는 것만으로 즐거워.
$^そうかな、(.+?)と一緒にいるとすごく落ち着くというか、癒されるよ。$	그럴까, $1와 함께 있으면(자) 몹시 침착한다고 하는지, 치유되어.
$^大丈夫、(.+?)ならできるよ。自信持って。$	괜찮아, $1라면 가능해. 자신 가져.
$^そりゃまあ、(.+?)と夜伽ができるからね。$	그렇다면 뭐, $1와 밤시중이 생기니까요.
$^ああ、そうだね。(.+?)は、好きなお酒はないのかな。$	아, 그렇다. $1는, 좋아하는 술은 없는 것인지.
$^通って感じがするよ。これから日本酒を選ぶ時は、(.+?)に聞くことにしようかな。$	다녀 느낌이 들어. 지금부터 일본술을 선택할 때는, $1에 듣기로 할까.
$^(.+?)はこの仕事について、どう思ってるの？$	$1는 이 일에 종사해, 어떻게 생각해?
$^そうとも言えるけど……(.+?)も楽しんでくれないと。$	그렇다고도 말할 수 있지만…… $1도 즐겨 주지 않으면.
$^でも、相手のことをよく知ってる方が気持ちもこもるっていうか……(.+?)はそう思わない？$	그렇지만, 상대를 잘 알고 있는 (분)편이 기분도 가득찬다 라고 할까…… $1는 그렇게 생각하지 않아?
$^そっか、(.+?)は義理深いんだね。$	그래, $1는 의리 깊다.
$^(.+?)はどういう本が好きなのかな。$	$1는 어떤 책을 좋아하는가.
$^うーん、俺は(.+?)がメイドじゃなくても、気にかけると思うよ。$	응, 나는$1가 메이드가 아니어도, 걱정한다고 생각해.
$^大丈夫、俺みたいな人間とは違って(.+?)は綺麗だから。何をやってても様になるしね。$	괜찮아, 나같은 인간과는 달라$1는 깨끗하기 때문에. 무엇을 해도님이 되기도 하고.
$^(.+?)は\1のままで十分に魅力的ってことだよ。$	$1는 $1인 채로 충분히 매력적은 것이야.
$^(.+?)は優しくて落ち着いているから、そう感じるのかもね。$	$1는 상냥해서 침착하고 있기 때문에, 그렇게 느끼는지도.
$^そうだ、今度(.+?)がダンスしている時にコールを――$	그렇다, 이번 $1가 댄스 하고 있을 때에 콜을--
$^もちろん(.+?)だけど。$	물론 $1이지만.
$^そんなことないって。(.+?)と一緒ならすごく癒されそうだ。$	그렇지 않다고. $1와 함께 말하는 매우 치유될 것 같다.
$^(.+?)は好きなスポーツとかってあるのかな。$	$1는 좋아하는 스포츠라든지는 있는 것일까.
$^うん、例えば(.+?)とかね。$	응, 예를 들면 $1라든지.
$^しょうがないだろ、(.+?)と夜伽したいって思う気持ちを抑えろだなんて無理な話だ！$	어쩔 수 없는이겠지, $1와 밤시중 하고 싶다고 생각하는 기분을 억제해라이라니 무리한 이야기다!
$^ねえ(.+?)、好きな動物っている？$	저기 $1, 좋아하는 동물은 있어?
$^おっ、もしかして(.+?)もコアラ派になった？$	, 혹시 $1도 코알라파가 되었어?
$^(.+?)はたくましい人が好きなんだね。$	$1는 씩씩한 사람을 좋아하구나.
$^いや、(.+?)に好かれる男になろうかなと。$	아니, $1에 사랑받는 남자가 될까와.
$^(.+?)って、何か好きな科目や授業はあった？$	$1는, 무엇인가 좋아하는 과목이나 수업은 있었어?
$^うまくなったら(.+?)にお店を飾ってもらいたいな。$	잘 되면(자) $1에 가게를 장식해 주었으면 한데.
$^秋か、(.+?)にはぴったりかもしれない。$	가을인가, $1에는 딱 맞을지도 모른다.
$^秋ってもの悲しい感じがあるんじゃない。(.+?)も、たまにそういう雰囲気があるからさ。$	가을이라고 해도의 슬픈 느낌이 있지 않다. $1도, 이따금 그러한 분위기가 있기 때문에.
$^うん、明日の昼食は(.+?)に旬の食べ物を聞いて選ぼうかな。$	응, 내일 점심식사는 $1에 순의 음식을 (들)물어 선택할까.
$^(.+?)も人恋しくなることはあるの？$	$1도 사람 그리워지는 것은 있는 거야?
$^(.+?)がとんかつにかぶりつく姿って、あまり想像できないなぁ。$	$1가 돈까스에 덥석 무는 모습은, 그다지 상상할 수 없다.
$^(.+?)も一緒に食べようよ。みんなの分も一緒に頼むからさ。$	$1도 함께 먹자. 모두의 분도 함께 부탁하기 때문에.
$^(.+?)の恋愛観を教えて欲しいんだけど。$	$1의 연애관을 가르쳐 주셨으면 하지만.
$^(.+?)にとって、どういうのが恋愛なのかってことだね。$	$1에 있어, 어떤의가 연애인가는 일이구나.
$^俺の容姿はどう？　(.+?)の恋愛対象に入ってるのかな。$	나의 용모는 어때?　$1의 연애 대상으로 들어가 있을까.
$^(.+?)と大体同じかな。好きになるかどうかなんて、その時になってみなきゃわからないよ。$	$1와 대개 같은가. 좋아하게 될지 어떨지는, 그 때가 되어 보지 않으면 몰라.
$^そっか。じゃあこれから(.+?)のドアはたっぷりとノックして、準備を調えてあげるよ。$	그래. 자 지금부터$1의 문은 충분히노크 해, 준비를 준비해 줄게.
$^もし宝くじが当たったら、(.+?)はどうする？$	만약 복권이 당첨되면(자), $1는 어떻게 해?
$^もちろんその中には(.+?)も入ってるからね。覚悟してよ。$	물론 그 중에는 $1도 들어가고 있으니. 각오 해.
$^帰ってくればみんなが待ってるしね。(.+?)にも会えるし。$	돌아오면 모두가 기다리고 있지요. $1에도 만날 수 있고.
$^(.+?)と二人で行くに決まってるだろ。$	$1와 둘이서 가는에 정해지고 있지.
$^４月くらいから水が張って、辺り一面が鏡みたいになるんだ。すっごく綺麗なんだよ。(.+?)と一緒に見てみたいな。$	4월 정도로부터 물이 쳐, 근처 일면이 거울같이 된다. 대단히 깨끗해. $1와 함께 보고 싶은데.
$^(.+?)が言われて嬉しい言葉ってなに？$	$1가 말해져 기쁜 말은 뭐?
$^(.+?)、綺麗だよ。$	$1, 깨끗해.
$^最近(.+?)が頑張ってるから、どうやって褒めたらいいのかなって。$	최근 $1가 노력하고 있으니, 어떻게 칭찬하면 좋은 것인지는.
$^(.+?)は俺の大事なメイドだからね。当然だよ。$	$1는 나의 소중한 메이드니까. 당연해.
$^でも、(.+?)がメイドじゃなくても見てると思うよ。綺麗だし、すごくかわいいからさ。$	그렇지만, $1가 메이드가 아니어도 보고 있다고 생각해. 깨끗하고, 몹시 귀엽기 때문에.
$^いや、(.+?)が夜伽をしてくれる時は、いても立ってもいられないよ。$	아니, $1가 밤시중을 해 줄 때는, 있어도 서고 있을 수 없어.
$^(.+?)は、どんな人を旦那さんにしたいの？$	$1는, 어떤 사람을 신랑으로 하고 싶은거야?
$^(.+?)がお嫁さんだったら、毎日おいしいご飯を食べさせてくれそうだね。$	$1가 신부라면, 매일 맛있는 밥을 먹여 줄 것 같다.
$^よし、(.+?)。俺と結婚しよう！$	좋아, $1. 나와 결혼하자!
$^ごめんな、(.+?)。俺が傍にいる間はその涙を拭ってあげる。$	미안, $1. 내가 옆에 있는 동안은 그 눈물을 닦아 준다.
$^(.+?)は、血液型で性格診断とか信じる方？$	$1는, 혈액형으로 성격 진단이라든지 믿는 (분)편?
$^(.+?)が真面目すぎるからじゃない？$	$1가 너무 성실하기 때문이 아니야?
$^(.+?)は典型的な日本人、って感じだよね。$	$1는 전형적인 일본인, 이라는 느낌이지요.
$^(.+?)ってホラー系は全然平気なんだ。$	$1는 호러계는 전혀 아무렇지도 않다.
$^俺に憑いてる悪霊を祓って欲しい。頼む、退治屋の(.+?)！$	나에게 달라붙어 있는 악령을 쫒아줬으면 좋겠어. 부탁해, 퇴마사 $1!
$^ということで、(.+?)にはこれから巫女になってもらおうかな。$	그렇다고 하는 것으로, $1에는 지금부터 무녀가 되어 줄까.
$^(.+?)は何か得意料理ってある？$	$1는 무엇인가 자신있는 요리는 있어?
$^(.+?)が作ってくれるなら何でもいいよ。$	$1가 만들어 준다면 뭐든지 좋아.
$^(.+?)の作る煮物が食べてみたい。きっとおいしいんだろうなぁ。$	$1가 만드는 조림을 먹어 보고 싶다. 반드시 맛있겠지.
$^んー、(.+?)が一番好きなやつがいいかかな。$	응―, $1가 제일을 좋아하는 녀석이 좋은가일까.
$^(.+?)だよ。$	$1야.
$^(.+?)が作ってくれた料理を食べた後で\1もいただいちゃうとか、すごく贅沢だよね！$	$1가 만들어 준 요리를 먹은 다음에 $1도 받아버리자(면)인가, 몹시 사치지요!
$^いやさ、今日はなぜか(.+?)と夜伽がしたくてたまらないんだ。$	싫음, 오늘은 왠지$1와 밤시중을 하고 싶어서 견딜 수 없다.
$^多分、(.+?)が魅力的すぎるからだね。$	아마, $1가 매력적 지나기 때문이구나.
$^女の子も一緒じゃないかな。(.+?)はすごくエッチがしたいって時ない？$	여자 아이도 함께가 아닐까. $1는 몹시 외설을 하고 싶다는 때 없어?
$^はは、正直言うとつらいけど、がっついて(.+?)に嫌われたくないしね。$	(은)는은, 솔직히 말하면(자) 괴롭지만, 이 붙어$1에 미움받고 싶지 않기도 하고.
$^ねえ(.+?)、俺の事どれぐらい好き？$	저기 $1, 나의 일어느 정도를 좋아하는 사람?
$^わ、わかった。これからは(.+?)だけに愛情を注ぐよ！$	원, 알았다. 지금부터는 $1인 만큼 애정을 따라!
$^全ての愛を(.+?)に捧げるよ。$	모든 사랑을 $1에 바쳐.
$^うん、俺の恋人は(.+?)だけだからね。$	응, 나의 연인는 $1뿐이니까.
$^もう少し、その……(.+?)に向き合えるぐらい立派になりたいんだ。$	좀 더, 그…… $1에 마주볼 수 있는 정도 훌륭하게 되고 싶다.
$^(.+?)は、好きな人とどれぐらいエッチしたい？$	$1는, 좋아하는 사람과 어느 정도 섹스하고 싶어?
$^夜だけじゃなくて起きたばかりの(.+?)ともエッチしたいし、仕事をしてる\1ともエッチしたい。$	밤만이 아니고 일어난지 얼마 안된 $1와도 섹스하고 싶고, 일을 하고 있는 $1와도 섹스하고 싶다.
$^ただ、(.+?)の身体が心配だなぁ。エッチしすぎたら倒れちゃうだろうし。$	다만, $1의 신체가 걱정이다. 너무 섹스하면(자) 넘어져버린다일 것이다 해.
$^い、いやほら、(.+?)とは毎日顔を合わせて話をするからさ。それで十分に楽しいし。$	있고, 아니 이봐요, $1와는 매일 얼굴을 맞대어 이야기를 하기 때문에. 그래서 충분히 즐겁고.
$^そんなこと起こるわけがないだろ。俺は(.+?)が好きなんだから。$	그런 일 일어나는 것이 없는이겠지. 나는 $1를 좋아하니까.
$^もちろん(.+?)を選ぶよ。これは絶対だ。$	물론 $1를 선택해. 이것은 절대다.
$^でも、(.+?)を幸せにするって決めた。だから恋人になったんだしね。$	그렇지만, $1를 행복하게 한다 라고 결정했다. 그러니까 연인가 되었다 죽어라.
$^もちろん、今は誰よりも(.+?)が好きだし、\1がこの世の中で一番大事だよ。$	물론, 지금은 누구보다 $1를 좋아하고, $1가 이 세상에서 제일 소중해.
$^(.+?)も幸せにするし、好きになった子も幸せにする。これで全員ハッピーだ！$	$1도 행복하게 하고, 좋아하게 된 아이도 행복하게 한다. 이것으로 전원 해피다!
$^えっと、(.+?)の理想って……$	어와, $1의 이상은……
$^そうなんだけど、(.+?)が恥ずかしがってくれないと。$	그렇구나하지만, $1가 부끄러워해 주지 않으면.
$^ご、ごめん……でも俺、(.+?)とエッチしたい……！$	미, 미안…… 그래도 나, $1와 H하고 싶다……!
$^もう我慢できない……(.+?)、すぐに部屋へ行こう！$	이제 참을 수 없어…… $1, 곧바로 방에 가자!
$^(.+?)は本当に真面目で一途だね。$	$1는 정말로 성실하고 한결같다.
$^いや、言わないよ。(.+?)の綺麗な身体を独り占めしたいからね。$	아니, 말하지 않아. $1의 깨끗한 신체를 독점하고 싶으니까.
$^あー、それはね、ちょっと(.+?)を試したくなって。$	아―, 그것은요, 조금 $1를 시험하고 싶어져.
$^むしろみんなに分け与えたい！　(.+?)の素晴らしさを全世界に伝えたい！$	오히려 모두로 나누고 주고 싶다!　$1의 훌륭함을 전세계에게 전하고 싶다!
$^方法は考えてないけど、(.+?)の美しさをみんなに知ってもらいたいって思ってるよ。$	방법은 생각하지 않지만, $1의 아름다움을 모두가 알아 주었으면 한다고 생각하고 있어.
$^いいや、ダメだ。(.+?)の美しさを知らない、なんて人類の大いなる損失だよ。$	좋아, 안된다. $1의 아름다움을 모르는, 뭐라고 하는 인류의 커다란 손실이야.
$^それくらい(.+?)は素晴らしい恋人だってことだよ。$	그 정도 $1는 훌륭한 연인도 일이야.
$^(.+?)、デートするならどこに行きたい？$	$1, 데이트 한다면 어디에 가고 싶어?
$^そりゃエッチもしたいけど、それ以外のことも(.+?)と一緒に楽しみたいんだよ。$	그렇다면 외설도 하고 싶지만, 그 이외도 $1와 함께 즐기고 싶어.
$^(.+?)はどういう映画が好き？$	$1는 어떤 영화를 좋아해?
$^いや、(.+?)と行くなら恋愛ものも楽しいと思うよ。$	아니, $1와 간다면 연애의 것도 즐겁다고 생각해.
$^うんうん。(.+?)と二人で、仕事を忘れて休みを満喫したいね。$	응응. $1와 둘이서, 일을 잊어 휴일을 만끽하고 싶다.
$^ははは、(.+?)はエッチだなぁ。$	하하하, $1는 음란하다.
$^そんなことないよ。俺も(.+?)とエッチしたいし。$	그렇지 않아. 나도 $1와 섹스하고 싶고.
$^まあね、そういう施設だし。(.+?)は遊園地が嫌い？$	그냥, 그러한 시설이고. $1는 유원지가 싫어?
$^いや、それじゃやめた方がいいかな。(.+?)が楽しくないんじゃ俺も楽しくないし。$	아니, 그러면 그만두는 것이 좋을까. $1가 즐겁지 않지 나도 즐겁지 않고.
$^俺も(.+?)が感じている時のかわいらしい顔が、すごく愛おしいと思うよ。$	나도 $1가 느끼고 있을 때 의 것인지원 오셔 있고 얼굴이, 몹시 사랑 아깝다고 생각해.
$^ごめんね。でも恥ずかしそうな(.+?)を見るとたまらなくなるんだよ。$	미안해요. 그렇지만 부끄러운 것 같은 $1를 보면(자) 견딜 수 없게 되어.
$^(.+?)が気持ちよさそうな顔してるのを見ると、俺もその分、気持ちよくなれるんだ。$	$1가 기분이야 유혹한데 얼굴 하고 있는 것을 보면(자), 나도 그 만큼, 기분 좋게 될 수 있다.
$^うん、普段は清楚で真面目な(.+?)がだらしない顔をするなんて、すっごくレアだしね。$	응, 평상시는 청초로 성실한 $1가 야무지지 못한 얼굴을 하다니 대단히 레어이고.
$^(.+?)は食べないの？$	$1는 먹지 않는거야?
$^(.+?)は、寝る前に何か考えたりする？$	$1는, 자기 전에 무엇인가 생각하거나 해?
$^俺は今のままの(.+?)でも十分好きだし、満足してるよ。$	나는 지금 인 채의 $1에서도 충분히 좋아하고, 만족하고 있어.
$^そ、そうだね。俺も(.+?)に嫌われないよう努力しないと。$	, 그렇다. 나도 $1에 미움받지 않게 노력하지 않으면.
$^違う違う、(.+?)は今でも十分過ぎるくらい色々とやってくれてるから、努力なんてしなくても十分満足してるんだよ。$	다른 다른, $1는 지금도 너무 충분할 정도로 다양하게 해 주고 있으니, 노력은 하지 않아도 충분히 만족하고 있어.
$^大丈夫、(.+?)が好きだって気持ちは変わらない。俺を信用してよ。$	괜찮아, $1를 좋아한다고 기분은 변함없다. 나를 신용해.
$^(.+?)には、もっとわがままを言って欲しいな。$	$1에는, 좀 더 이기적임을 말했으면 좋은데.
$^そう、俺に尽くしてくれるのは嬉しいけど、俺も(.+?)に何かしてあげたい。$	그래, 나에 힘써 주는 것은 기쁘지만, 나도 $1에 무엇인가 해 주고 싶다.
$^でも(.+?)はわがままを言わないから、何もしてあげられないんだよ。$	그렇지만 $1는 이기적임을 말하지 않기 때문에, 아무것도 해 줄 수 없어.
$^(.+?)、努力して欲しいことを聞いたんでしょ？$	$1, 노력해 주었으면 한 것을 (들)물었겠지?
$^早く(.+?)がステージの上で輝く姿を見てみたいな！$	빨리 $1가 스테이지 위에서 빛나는 모습을 보고 싶은데!
$^(.+?)が怒ってるとこって見たことないんだよね。$	$1가 화내고 있다고(면) 개는 본 적 없어.
$^そういうことだよ。だから(.+?)にはなるべく喜んでもらいたいし、楽しくしててもらいたいな。$	그런 것이야. 그러니까 $1에는 가능한 한 기뻐해 주었으면 하고, 즐겁게 해도들 아픈데.
$^ああ、(.+?)には悪いけど……好きな子が悲嘆にくれる顔って燃えるんだよ！$	아, $1에는 나쁘지만……좋아하는 아이가 비탄에 잠기는 얼굴은 불타!
$^もし(.+?)が他の男の手篭めにされたら……すごい悔しいけどメチャクチャ興奮すると思う！$	만약 $1가 다른 남자의 괴롭힘으로 되면(자)……대단히 분하지만 메체크체 흥분한다고 생각한다!
$^うん、(.+?)はできると思う？$	응, $1는 할 수 있다고 생각해?
$^うん。まあ上手じゃなくても、(.+?)とキスできれば何でもいいけどね。$	응. 뭐 능숙하지 않아도, $1와 키스 할 수 있으면 뭐든지 좋지만요.
$^いや、今のままでいいから。(.+?)とは普通にキスしたいよ。$	아니, 지금 그대로 좋으니까. $1와는 보통으로 키스 하고 싶어.
$^面白くなくてもいいんだよ。(.+?)とキスできればそれだけで幸せなんだから。$	재미있지 않아도 괜찮아. $1와 키스 할 수 있으면 그 만큼으로 행복하니까.
$^ハイペースだね、大丈夫？　(.+?)。$	하이 페이스구나, 괜찮아?　$1.
$^ふふ、それで、気持ちよくなっちゃった(.+?)は、お客様にお持ち帰りされちゃって……$	후후, 그래서, 기분 좋아져 버렸다$1(은)는, 손님에게 가지고 돌아가하셔 버려서……
$^ふぅん？　じゃあ(.+?)の好きそうな可愛い系の男の子がさ『お姉ちゃ～ん♪』なんて言っておねだりしてきたら？$	응?　자$1(이)가 좋아할 것 같은 사랑스러운 계의 사내 아이가 「언니(누나)~응♪」이라고 말해 졸라댐 해 오면(자)?
$^あはは、そうだろうね。そこは信頼してるよ、(.+?)。$	아하하, 그렇겠지. 거기는 신뢰하고 있어, $1.
$^顔が赤いよ、(.+?)。$	얼굴이 붉어, $1.
$^ふふ、でもそれ以上に、他の男の人にじろじろ(.+?)を見られて恥らう\1の姿も見ていたいかな。$	후후, 그렇지만 그 이상으로, 다른 남자에게 빤히$1(을)를 볼 수 있어 수치\1의 모습도 봐 아플까.
$^ほら、リラックスして。そうじゃないと(.+?)の良さは出ないじゃないか。$	이봐, 진정해. 그렇지 않으면 $1의 장점이 나오지 않을 것 같다고.
$^(.+?)、なんだかすごく緊張してない？$	$1, 어쩐지 몹시 긴장하고 있지 않아?
$^(.+?)のおしっこなら直飲みできるよ！$	$1의 오줌이라면 바로 마시는 거 할 수 있어!
$^(.+?)は好きな本のジャンルとかある？$	$1는 좋아하는 책의 장르라든지 있어?
$^それで態度が変わるような(.+?)じゃないって知ってるから、いいよ$	그래서 태도가 바뀌는 것 같은 $1가 아니라고 알고 있으니까, 괜찮아.
$^いや民謡も侮れないよ。(.+?)にきっと似合うと思う$	아니, 민요도 경시할 수 없어. $1에게 정말 어울린다고 생각해.
$^(.+?)はテレビって見る？　好きなテレビ番組ってどういうのかな$	$1는 텔레비젼은 봐? 좋아하는 TV프로는 어떤 것일까.
$^見てる時の(.+?)ってきっとすごく可愛いんだろうな$	보고 있는 때의 $1는 정말 많이 사랑스럽겠지.
$^(.+?)は癒し系だね$	$1는 치유계구ㅏ.
$^(.+?)がよく笑っていてくれると、俺も嬉しいよ$	$1가 잘 웃어 주면, 나도 기뻐.
$^モロに対戦だもんね。(.+?)は苦手かも$	정면 대결이구나. $1는 서투를지도.
$^(.+?)の好きな動物って何？$	$1가 좋아하는 동물은 뭐야?
$^そんなことないよ。(.+?)は偉いから褒めたいんだ。よっ、このメスブタ！$	그렇지 않아. $1는 훌륭하니까 칭찬하고 싶어. 이 암퇘지!
$^(.+?)は好きな科目とか授業とかって、何だった？$	$1는 좋아하는 과목이라든지 수업이라든지는, 뭐였을까?
$^(.+?)の好きな季節はいつ？$	$1가 좋아하는 계절은 언제야?
$^たぶんね。なんだか(.+?)にぴったりな花だね$	아마. 어쩐지 $1에 딱 맞는 꽃이구나
$^そんなことないよ。満開の桜の下で佇む(.+?)……きっとすごく絵になるよ$	그렇지 않아. 만개의 벚꽃 아래에서 잠시 멈춰서는 $1……분명 몹시 그림이 될 거야.
$^じゃあ、(.+?)のミルクをご馳走してもらおう$	그럼, $1의 밀크를 대접받자.
$^ちょっといいかな？　(.+?)の恋愛観を聞きたいんだけど……$	조금 괜찮을까? $1의 연애관을 듣고 싶은데……
$^あれ、(.+?)って結構尽くしそうな感じもするんだけど……。$	어라, $1는 상당히 다 할 것 같단 느낌이 드는데…….
$^それは(.+?)みたいなメイドたちの事に決まってるじゃないか。$	그건 $1 같은 메이드들의 일로 정해져 있는 게 아닌가.
$^(.+?)は俺の事を想っててくれてるのかな？$	$1는 내 일을 생각해주고 잇는 걸까?
$^(.+?)の事に決まってるよ。いつも君を想ってる。$	$1의 일로 정해져 있어. 언제나 너를 생각하고 있다.
$^そ、その……(.+?)の事も含まれてるよ？$	그, 그…… $1의 일도 포함되어 있어?
$^あのさ、(.+?)は休日ってどう過ごしているの？$	그런데 말이야, $1는 휴일은 어떻게 보내고 있는 거야?
$^うっ……その、い、いつもありがとう(.+?)。$	……그, 어, 언제나 고마워, $1.
$^うん、(.+?)の言う通りかもね。たまには少し刺激が欲しいけど。$	응, $1 말이 맞을지도. 가끔씩은 조금 자극을 갖고 싶은데.
$^(.+?)はダメだなぁ。休日を楽しむからお仕事も楽しめるのに。$	$1는 안되겠네. 휴일을 즐기기 때문에 일도 즐길 수 있는데.
$^(.+?)、宝くじって買ったことある？$	$1, 복권은 산 적 있어?
$^それがもし当たったら、(.+?)ならどうする？$	그것이 만약 당첨되면, $1라면 어떻게 할 거야?
$^それなら、(.+?)の世話だけしてもらえばいいんじゃない？$	그렇다면, $1의 뒷바라지만 받으면 되지 않아?
$^もちろん、(.+?)と一緒じゃないと楽しくないからね。$	물론, $1와 함께가 아니면 즐겁지 않으니까.
$^それに、夜だって(.+?)が居れば……。$	게다가, 밤도 $1가 있으면…….
$^楽しいに決まってるって！　その時は(.+?)も一緒に入れてあげるからね。$	즐거울 게 틀림없어! 그 때는 $1도 함께 넣어 줄게.
$^ねぇ(.+?)、旅行とかって興味ある？$	저기 $1, 여행이라든지는 흥미 있어?
$^大丈夫。(.+?)の要望にピッタリの所を見つけてくるから！$	괜찮아. $1의 희망사항에 딱 맞는 곳을 찾아올 테니까!
$^任せといて。(.+?)の為に頑張るよ。$	맡겨줘. $1를 위해 노력해 볼게.
$^よーし、それなら(.+?)がビックリするくらい、素敵な旅行プランを考えるよ。$	좋-아, 그렇다면 $1가 깜짝 놀랄 정도로, 멋진 여행 플랜을 생각해야지.
$^(.+?)ってどんな言葉を言われたら嬉しい？$	$1는 어떤 말을 말해지면 기뻐?
$^(.+?)って優しいよね。いつも助かってるよ。これからも俺の世話を焼いて欲しいな。$	$1는 상냥하지. 언제나 도움이 되고 있어. 앞으로도 나를 보살펴줬으면 좋겠는걸.
$^(.+?)ってすっごく綺麗だよね。$	$1는 매우 아름답지.
$^うん、(.+?)を見てたら、素直にそう思ったからさ。$	응, $1를 보고 있으면, 솔직하게 그렇게 생각했으니까.
$^本心だよ。いつもありがとう(.+?)。$	본심이야. 언제나 고마워, $1.
$^うん。(.+?)みたいなお姉ちゃんが居たら、幸せだろうなって思うよ。$	응. $1 같은 누나가 있으면, 행복할 것이라고 생각해.
$^あのさ、(.+?)。一度聞いてみたかったんだけど。$	그런데 말이야, $1. 한 번 들어 보고 싶었지만.
$^確かにそれって(.+?)らしいかも。世話を焼くの好きそうだし。$	확실히 그건 $1 같을지도. 보살피는 걸 좋아할 것 같고.
$^俺も(.+?)にお世話をされていて、楽しいよ。$	나도 $1에게 신세를 지고 있고, 즐거워.
$^うん、頼むよ。(.+?)が居れば安心だから。$	응, 부탁해. $1가 있으면 안심이니까.
$^ねえ(.+?)、誰かの世話を焼くって楽しいの？$	저기 $1, 누군가를 보살핀다는 것은 즐거운 거야?
$^あのさ、(.+?)は血液型の性格診断とかどう思う？$	그런데 말이야, $1는 혈액형의 성격 진단이라든지 어떻게 생각해?
$^う……ま、まあ(.+?)がＯ型だって言われるのは多分いい方の意味だよ。間違いないって。$	……뭐, 뭐 $1가 O형이라도 말하는 것은 아마 좋은 쪽의 의미야. 틀림없다고.
$^それは違う、(.+?)は適当じゃないって言おうと思ったんだよ。$	그건 달라, $1는 적당하지 않다고 말하려고 생각했어.
$^うん、もちろん。だって(.+?)はよく気が付くし、お仕事もしっかりやってくれてるしね。$	응, 물론. 왜냐하면 $1는 잘 깨닫고, 일도 제대로 해주고 있지.
$^もちろん。(.+?)の事はいつだって見てるよ。$	물론. $1의 일은 언제나 보고 있어.
$^(.+?)ってたまによくわからないよね……。$	$1는 가끔 잘 모르는구나…….
$^やっぱり(.+?)って独特の感性してる気がするなぁ……。$	역시 $1는 독특한 감성을 가지고 있다는 생각이 드는데…….
$^うん、(.+?)って本当に優しい子だよね。感心したよ。$	응, $1는 정말로 상냥한 아이지. 감탄했어.
$^そうだ、(.+?)の得意料理って何？$	그렇지, $1의 특기 요리는 뭐야?
$^(.+?)って結構――$	$1는 상당히--
$^うん、家庭の味って良い物だと思うし、(.+?)が作るなら期待できそうだから。$	응, 가정의 맛은 좋은 것이라고 생각하고, $1가 만든다면 기대할 수 있을 테니까.
$^そ、その……(.+?)？　あのさ……。$	그…… $1? 그런데 말이야…….
$^(.+?)を見てたらなんだかムラムラしてきてさ……何とかしてくれないかな？$	$1를 보고 있으면 어쩐지 불끈불끈해지는 게……어떻게 안 될까?
$^……え？　(.+?)、もしかして……。$	……엥? $1, 혹시…….
$^わっ、そっ、その！　(.+?)！　ま、待って！$	앗, 아, 그! $1! 기, 기다려!
$^うん、わかったよ。悪かったね、(.+?)。$	응, 알겠어, 나빴어, $1.
$^(.+?)、わかっててやってたんだ……。$	$1, 알고 있었구나…….
$^……(.+?)にはかなわないなぁ。$	…… $1에게는 이길 수 없겠네.
$^いや、何かあのまま(.+?)にさせるのも悪い感じがして。でも続けて欲しい気持ちもあったからさ。$	아니, 뭔가 그대로 $1에게 시키는 것도 나쁘단 생각이 들어. 그렇지만 계속했으면 좋겠다는 기분도 들었으니까.
$^ねえ(.+?)、俺の事どれぐらい好き？俺のこと、どれくらい好きかな？$	저기 $1, 날 얼마나 좋아해? 나를, 얼마나 좋아할까?
$^(.+?)が俺のことを大切にしてくれているのは分かるんだけど、言葉で聞いてみたくて。$	$1가 나를 소중히 해주고 있는 것은 아는데, 말로 들어보고 싶어서.
$^けど、大切なことは本当だよ！　(.+?)は、俺にとっていなくちゃならない存在だから！$	하지만, 중요한 건 사실이야! $1는, 나에게 없어선 안 되는 존재니까!
$^(.+?)は、俺にとってはただのメイドじゃない。特別な存在だから……上手く言葉に、できなくて。$	$1는, 나에게 있어서는 단순한 메이드가 아니다. 특별한 존재이니까……말을 잘, 못 해서.
$^いやその、(.+?)が喜んでくれると思って。$	아니 그, $1가 기꺼이 준다고 생각했어.
$^……ごめん。今はまだ無理なんだ。エンパイアクラブのオーナーとしてまだまだ未熟だし、(.+?)を護ってあげられる力も足りない。$	……미안. 지금은 아직 무리야. 엠파이어 클럽의 오너로써도 아직 미숙하고, $1를 지켜 줄 수 있는 힘도 부족해.
$^ありがとう、(.+?)$	고마워, $1.
$^(.+?)は、好きな人とのエッチはどれぐらいしたい？$	$1는, 좋아하는 사람과의 섹스는 어느 정도 하고 싶어?
$^そりゃそうだよ。大好きな(.+?)と愛し合いたいと思うのは当然だろ？　だからこうして、今日は指名したんだ。$	그렇다면 그래. 정말 좋아하는 $1와 서로 사랑하고 싶다고 생각하는 것은 당연하겠지? 그러니까 이렇게, 오늘은 지명했어.
$^それに、仕事に疲れている時、(.+?)と一緒にいると癒されるから。$	게다가, 일에 지쳤을 때, $1와 함께 있으면 치유되니까.
$^いつだってさ。夜だけじゃない、朝も、昼も、ずっと(.+?)とエッチしたいって思ってる。$	언제든. 밤만이 아닌, 아침도, 낮도, 쭉 $1와 섹스하고 싶다고 생각하고 있어.
$^もし、俺が他に好きな人ができたって言ったら、(.+?)はどうする？$	만약, 내가 그 밖에 좋아하는 사람이 생겼다고 하면, $1는 어떻게 할 거야?
$^いたいいたいっ！　そんなにしなくても大丈夫だよ、今のは例え話だから。(.+?)と別れるなんて、絶対にありえないよ。$	아파, 아프다고! 그렇게 하지 않아도 괜찮아, 지금 건 농담이니까. $1와 헤어지다니 절대로 있을 수 없어.
$^大げさじゃないよ。俺にとって、(.+?)はかけがえのない存在だから。メイドとしてだけじゃない……だから、恋人なんだろ？$	과장한 거 아니야. 나에게 있어서, $1는 둘도 없는 존재이니까. 메이드로서만이 아닌……거니까, 애인이겠지?
$^その、(.+?)が泣くところを見たくなって。好きな子のことは虐めたくなるってヤツ。$	그, $1가 우는 걸 보고 싶어서. 좋아하는 아이는 괴롭히고 싶다는 느낌이랄까.
$^でもそこから、新たなプレイを憶えているんだ！　いつも同じプレイばかりだと、マンネリになっちゃうだろ。俺、もっと(.+?)のことを喜ばせてあげたいから。$	그렇지만 거기로부터, 새로운 플레이를 기억하고 있어! 언제나 같은 플레이만 한다면, 매너리즘이 되어 버리겠지. 나, 좀 더 $1를 기쁘게 해 주고 싶으니까.
$^ごめんごめん。(.+?)の生の反応が見たくてさ。でも、今のが本当だったら？$	미안 미안. $1의 자연스러운 반응을 보고 싶어서. 그렇지만, 지금 것이 사실이라면?
$^今、シタいわけじゃないよ、アンケートさ。(.+?)が興味を持っているなら、夜伽に組み込んでみたいし。$	지금, 이상한 게 아니라, 앙케이트야. $1가 흥미를 가지고 있다면, 밤시중에 집어넣어 보고 싶고.
$^(.+?)は俺だけが触れる、俺だけのメイドだって、周りに知らしめて、悪い虫がつかないようにしたくなるのさ。$	$1는 나만 만지고, 나만의 메이드라고, 주위에 알려서, 나쁜 벌레가 붙지 않게 하고 싶어지는 거야.
$^(.+?)の反応が可愛かったから、ちょっと意地悪したくなっちゃったんだ。$	$1의 반응이 사랑스러웠으니까, 조금 심술부리고 싶어져 버렸어.
$^デートに行くとしたら、(.+?)は何処に行きたい？$	데이트에 간다고 하면, $1는 어디에 가고 싶어?
$^酔っ払うにはまだ早いよ。バーでお酒を楽しんだら、最後は(.+?)のために予約した最上階のスイートルームにエスコートしたいんだから。$	취하는 건 아직 일러. 바에서 술을 즐기면, 최후는 $1를 위해서 예약한 최상층의 스위트 룸에 에스코트 하고 싶으니까.
$^いやいや、絶対面倒くさいって。リア充ばっかり集まってるようなところだよ？　第一、(.+?)はそういうところ行ったことあるの？$	아니아니, 진짜 귀찮다고. 리얼충뿐 모이는 것 같은 곳이야? 첫째, $1는 그런 곳 간 적 있어?
$^(.+?)から見て、グっとくる男の仕草ってある？$	$1가 볼 때, 훨씬 오는 남자의 행동 같은 건 있어?
$^全然気づいてなかったよ。でも、俺も(.+?)が仕事をしているところを見かけると、ついつい目が引き寄せられちゃうかなぁ。$	전혀 눈치채지 못했어. 하지만 나도 $1이 일을 하고 있는 것을 볼 때, 그만 눈이 이끌려 버리는 걸까.
$^改めて言われると、照れるね。恥ずかしいな。まあ、俺も(.+?)のエッチな顔は好きだけど。$	다시 말하면 쑥스럽네. 쑥스럽다. 음, 나도 $1의 야한 얼굴은 좋아하지만.
$^そんなことされなくても、もう(.+?)の虜だから大丈夫だよ。……でも、楽しみにしているから。$	그런 일을 당하지 않아도, 벌써 $1의 포로이니까 괜찮아. ……그렇지만, 기대하고 있을 테니까.
$^でもなぁ。(.+?)に翻弄されているみたいで、男としてのプライドがさぁ。$	그래도, $1에게 우롱당하고 있는 것 같고 남자로서 자존심이 말이지
$^その分、(.+?)にはエッチな顔をしてもらうから、覚悟しておいてね。$	그만큼, $1에는 음란한 얼굴을 해달라고 할 테니까, 각오해 둬.
$^(.+?)、お願いできるかな？$	$1, 부탁할 수 있을까?
$^そうだよ。(.+?)がもっと親密に身の回りの世話をしてくれるなら、俺も嬉しいし。でも、他に仕事が忙しいから難しいかな？$	그래. $1가 좀 더 친밀하게 신변을 돌봐 준다면, 나도 기쁘고. 그렇지만, 그 밖에 일이 바쁘기 때문에 어려울까?
$^(.+?)はさ、寝る前に何か考えたりする？$	$1는 , 자기 전에 무엇인가 생각하거나 해?
$^ううん、気にしないでよ。疲れていてもさ、(.+?)と一緒にいると吹き飛ぶんだ。$	으응, 신경쓰지 마. 피곤해도, $1와 함께 있으면 날아갈 것 같으니까.
$^きみのことだよ。(.+?)の顔を思い浮かべたり、声を思い浮かべたりするんだ。そうすると、明日も頑張ろうって気持ちになるんだよ。$	너에 관한 것이야. $1의 얼굴을 떠올리거나 소리를 떠올리거나 해. 그렇다면, 내일도 힘내자는 기분이 들거든.
$^あとはその、ムラムラしてる時なんかは(.+?)のエッチなところを思い出したり……。$	그리고는 그, 불끈불끈하고 있는 때는 $1의 음란한 곳을 생각해 내거나…….
$^エッチしている時さ、(.+?)は責めたい？　それとも責められる方が好き？$	섹스하고 있을 때, $1는 꾸짖고 싶어? 그렇지 않으면 꾸짖어지는 것이 좋아?
$^もちろん、ガンガン責めたい！　(.+?)の弱いところを責めまくって、エッチでとろとろな顔を見ると征服感が満たされるんだ。$	물론, 엄청나게 꾸짖고 싶어! $1의 약한 곳을 마구 꾸짖어, 음란하고 끈적끈적한 얼굴을 보면 정복감이 채워져.
$^仕方ないだろう、男なんだし。……(.+?)はそういうのイヤ？$	어쩔 수 없어, 남자니까. …… $1는 그런 거 싫어?
$^責めたり責められたりじゃなくて、とにかく甘えたい……かな。(.+?)と一緒だと、すごく癒されるからさ。$	꾸짖거나 꾸짖어지거나가 아니고, 어쨌든 응석부리고 싶은 것……일까. $1와 함께라면, 몹시 치유되니까.
$^(.+?)はさ、さくらんぼのヘタを口の中で結ぶのってやったことある？$	$1는 , 체리의 열매 꼭지를 입 안에서 묶는 거 해본 적 있어?
$^あるんだ。で、(.+?)もやってみたの？$	있어. 그리고, $1도 해 봤어?
$^そんなことないよ。(.+?)とのキスは、すごく気持ち良くて大好きだよ。$	그렇지 않아. $1와의 키스는, 몹시 기분 좋아서 정말 좋아해.
$^俺は(.+?)とキスできてると思うだけですごく幸せになれているし。$	나는 $1와 키스할 수 있다고 생각만 하면 무척 행복해질 수 있어.
$^気にしなくて平気だと思うよ。すごく(.+?)とのキスはすごく気持ちいいし。第一、ヘタを結ぶのは俺もできなかったんだ。$	걱정하지 않아도 괜찮다 생각해. 굉장히 $1와의 키스는 무척 기분이 좋고. 첫째, 열매 꼭지를 묶는 것은 나도 할 수 없었어.
$^それなら、さくらんぼのヘタじゃなくて、(.+?)とキスをいっぱいした方が良くない？$	그렇다면, 체리의 열매 꼭지가 아니고, $1와 키스를 가득 하는 것이 좋지 않아?
$^じゃあ、今度する時は、俺からは何もしないようにしようかな。全部(.+?)にお任せ。$	그럼, 다음에 할 때는, 나는 아무것도 하지 않도록 할까. 전부 $1에게 맡기고.
$^(.+?)が、酔いと熱を残したままの口調で尋ねてきた。$	$1가, 취기와 열을 남긴 채로의 어조로 물어 왔다.
$^もちろん、だめじゃない。(.+?)が言わなかったら、俺から誘ってたよ。$	물론, 안되지 않아. $1가 말하지 않았으면, 나부터 권하고 있었어.
$^お酒のせいか、どこかふわふわとした様子で(.+?)はこちらを見た。$	술의 탓인지, 어딘가 둥실둥실 한 모습으로 $1는 이쪽을 보았다.
$^本当？　嬉しいよ、俺もまだ(.+?)と一緒にいたかったんだ。$	사실? 기뻐, 나도 아직 $1과 함께 있고 싶었던 것이다.
$^あぁ、大丈夫だよ。それに、(.+?)から誘ってもらったのに、飲めない訳ないだろ。$	아, 괜찮아. 게다가, $1로부터 권해 받았는데, 마실 수 없을 이유 없을 것이다.
$^(.+?)の、どこか遠慮がちな台詞が聞こえる。$	$1의, 어딘가 조심스런 대사가 들린다.
$^そんな事無いよ、行こうか、(.+?)から誘ってくれて嬉しいな。$	그렇지 않아, 갈까, $1가 가자고 해 줘서 기쁜데.
$^(.+?)から誘ってくれて嬉しいな。じゃ、行こうか？$	$1에서 꾀어 줘서 기쁘다. 그럼 갈까?
$^分かった……行こうか、(.+?)から誘ってくれて嬉しいな。$	알았어……갈까, $1로부터 권해줘서 기쁜데.
$^お疲れさま、(.+?)。$	수고 하셨습니다, $1.
$^でも、たまにはいいもんでしょ？　俺と(.+?)以外、誰も入ってないし。$	그렇지만, 가끔 씩은 좋은 걸이겠지?　나와$1이외, 아무도 들어 있지 않고.
$^さすが(.+?)だね。これは美味しそうだ。$	과연$1구나. 이것은 맛있을 것 같다.
$^うん、そこは信頼してるよ。なんといっても、(.+?)が作ってるからね。$	응, 거기는 신뢰하고 있어. 뭐니뭐니해도,$1가 만들고 있으니.
$^そうなんだ。俺も今度何か作って、(.+?)に食べてもらおうかな。$	그렇구나. 나도 이번에 무엇인가 만들어,$1에 먹어 줄까.
$^(.+?)はいつも精力的に働いてくれていたが、最近はどうにも仕事が多すぎるような気がする。$	$1는 언제나 정력적으로 일해 주고 있었지만, 최근에는 어떻게도 일이 너무 많은 것 같은 생각이 든다.
$^(.+?)、明日の用意はしなくていいよ。ついてきて欲しい所があるんだ。$	$1, 내일의 준비는 하지 않아 좋아. 따라 왔으면 좋은 곳이 있다.
$^珍しいな、(.+?)がそんな声出すなんて。$	드물다,$1가 그런 소리 내다니.
$^(.+?)はいつも頑張ってくれているし、疲れを口に出さないでしょ？$	$1는 언제나 노력해 주고 있고, 피로를 말하지 않지요?
$^だいたい、仕事の量が(.+?)は少し多いよね。そこら辺も調整しよう。$	대체로, 일의 양이$1는 조금 많지요. 그 정도옆도 조정하자.
$^……いつもありがとう、大好きだよ、(.+?)。$	……언제나 고마워요, 정말 좋아해,$1.
$^(.+?)に寄り添い、心地よい重さを肩に感じる。$	$1에 동행해, 기분 좋은 무게를 어깨에 느낀다.
$^(.+?)だったらどんなお弁当にする？$	$1라면 어떤 도시락으로 해?
$^話を聞いているだけでよだれが出てきたよ。(.+?)、それに近いお弁当とかいま作れる？$	이야기를 듣고 있는 것만으로 군침이 돌아 왔어. $1, 거기에 가까운 도시락이라든지 지금 만들 수 있어?
$^おお……さすが、(.+?)はしっかりしてるなぁ。$	……과연,$1젓가락빌리고 하고 있는.
$^確かに(.+?)は毎日のように働いて、休まる時がないように見える。$	확실히$1는 매일과 같이 일해, 편안해질 때가 없는 것 처럼 보인다.
$^よし、(.+?)。ちょっと付き合ってくれる？$	좋아,$1. 조금 교제해 줄래?
$^あれ、(.+?)？　もう起きてたんだ。$	저것,$1?　이제(벌써) 일어나고 있었어.
$^(.+?)は本当に働き者だなぁ……も、もっと可愛いものとかプレゼントしてもいいんだけど……$	$1는 정말로 일꾼이구나……도, 좀 더 사랑스러운 것이라든지 선물 해도 되지만……
$^(.+?)、どうしたの？$	$1, 왜 그래?
$^確かに。でも俺も自分で作るのは手を抜いてるから、(.+?)のだし巻き卵が楽しみだよ。$	확실히. 그렇지만 나도 스스로 만드는 것은 대충 하고 있으니,$1의 것이고 계란말이가 기다려져.
$^待って、(.+?)。今日のお弁当ってどれくらい用意してるの？$	기다려,$1. 오늘의 도시락은 어느 정도 준비해?
$^(.+?)、何読んでるの？$	$1, 무엇 읽어?
$^へえ……、でも、(.+?)は実際に自分で行ってみたいところとかないの？$	에 네……, 그렇지만,$1는 실제로 스스로 가 보고 싶은 곳 풀지 않는거야?
$^(.+?)のタコさんウインナーはどんな感じなんだろう。$	$1의 낙지씨윈나는 어떤 느끼고일까.
$^それは大丈夫。というかむしろ、調子悪そうなのに頑張ってる(.+?)を見たら、お客様が申し訳なく思っちゃうよ。$	그것은 괜찮아. 그렇다고 할까 오히려, 상태 나쁜 것 같은데 노력하고 있는 $1를 보면(자), 손님이 미안하다고 생각해버린다.
$^お疲れさま、(.+?)。$	수고 하셨습니다, $1.
$^ありがとう……、そういえば心なしか(.+?)の肌、いつもより綺麗だよね。何かしてるの？$	고마워요……, 그러고 보면 마음 탓인지 $1의 피부, 평소보다 깨끗하지. 무엇인가 해?
$^へえ。(.+?)でもそんなことするんだねぇ。へへへ。$	에. $1에서도 그런 일 하는 것이군. 에에에.
$^う、うん。(.+?)は真面目だなぁ……。$	, 응. $1는 성실하다…….
$^へえ、詳しいね。(.+?)は何度か見たことあるの？$	에 네, 자세하다. $1는 몇번인가 본 적 있는 거야?
$^そうかな。別に見つからなくても、俺は(.+?)と一緒に散歩に行きたいな。$	그럴까. 별로 발견되지 않아도, 나는 $1와 함께 산책에 가고 싶은데.
$^(.+?)はいいお母さんになれるよ。$	$1는 좋은 엄마가 될 수 있어.
$^……そうだね。とても(.+?)らしいよ。$	……그렇다. 매우 $1인것 같아.
$^嫌いっていうか、困るかな。(.+?)はどうして好きなの？$	싫다고 말하는지, 곤란할까. $1는 어째서 좋아해?
$^ずいぶん眠そうだね、(.+?)。昨日眠れなかった？$	대단히 졸린 것 같다, $1. 어제 잘 수 없었어?
$^はは、冗談だよ。(.+?)はそんな子じゃないって知ってるから。他の子の分も傘買ってくれてるんだよね？$	하하, 농담이야. $1는 그런 아이가 아니다고 알고 있으니. 다른 아이의 몫도 우산 사 주고 있어군요?
$^(.+?)はダメだなぁ$	$1는 안되겠네~
$^(.+?)って綺麗だよね$	$1는 아름답구나
