下半身に生暖かい感触を覚える。	하반신에 미지근한 감촉을 기억한다.
強弱をつけられ、俺のペニスが弄ばれていた。	강약을 붙여져 나의 페니스가 희롱해지고 있었다.
ふぅん……面白い、かも……んっ……寝ててもこんなんなんだ……？	응…… 재미있는, 일지도…… 읏…… 자도 이런 것이다……?
あれ、おきちゃったぁ……？　このまましこしこして、出させるのも面白そうだったけど……	저것, 규정 끝냈다아……? 이대로 쫄깃쫄깃 해, 내게 하는 것도 재미있을 것 같았지만……
ま、ご主人様の、その……気持ち良さそうな顔、好きだし、んっ……アタシの手でいっぱい感じてね……？	뭐, 주인님의, 그…… 기분 좋은 것 같은 얼굴, 좋아하고, 읏…… 나의 손으로 가득 느껴……?
ん……朝から、いっぱい……手コキしてあげる……んぅうん……	응…… 아침부터, 가득…… 손 애무 해 주는…… 우응……
んっ……んんぅっ……んぅっ……あっ、はぁっ……あぅっ……んっ、はぁっ……くぅっ……あっ……んくぅっ……んっ……はぁっ……	응…… 응응웃…… 응웃…… 앗, 하앗…… 아웃…… 읏, 하앗…… 쿠웃…… 앗…… 응쿠웃…… 읏…… 하앗……
はぁっ、はぁっ……んっ、んぅっ……！　あっ、はぅっ……んっ、くぅん……あっ、はぅっ！　んっ、んっ……んっ、んくぅっ……んんっ……！	후~, 하앗…… 읏, 응웃……! 앗, 하웃…… 읏, 쿠응…… 앗, 하웃! 읏, 읏…… 읏, 응쿠웃…… 응읏……!
ふああぁっ！！　……くぅ……いっぱい……	아!! …… 쿠우…… 가득……
出し過ぎぃ……はぁ、はぁ、手、べとべとになっちゃったじゃない……ふふっ……	너무 내고…… 하아, 하아, 손, 끈적끈적이 되어 버렸지 않은…… 후훗……
……もぉ、こんな凄い、その……精液の匂いしてたら、その……ドキドキして……	…… 도, 이런 굉장한, 그…… 정액의 냄새나 하고 있으면, 그…… 두근두근 해……
あぁ、でも、このままじゃダメだから……お、お風呂、いこっか……？	아, 그렇지만, 이대로는 안되기 때문에…… 요, 욕실, 갈까……?
…………洗うだけで、いいの？	………… 씻는 것만으로, 좋은거야?
エッチな音が下半身から響く。	엣치한 소리가 하반신으로부터 영향을 준다.
唾液のどろどろとした感触が、生々しい快楽を高めてくれていた。	타액의 질척질척으로 한 감촉이, 생생한 쾌락을 높여 주고 있었다.
ふふっ……んちゅっ……れるぅっ……どうかしら……？　はぁ……ちょっと……んっ……ドキドキ、するぅ……	후후…… 응츗…… 할짝…… 어떨까……? 하아…… 조금…… 읏…… 두근두근, 한다아……
朝フェラ……んちゅっ、っていうんだっけ？　はぁ、はぁ、どうせこういうの、好きなんれしょ……？　んちゅううっ……	아침 페라…… 응츗, 라고 하는 건가? 하아, 하아, 어차피 이런 것, 좋아인 실마리……? 응츄우웃……
ちゅぷっ……れるぅ……はぁ……はぁ、こんなに、朝から硬くさせてるほうが悪いんだから、んちゅっ、れるぅ……はぁ、はぁ……	…… 할짝…… 하아…… 하아, 이렇게, 아침부터 딱딱하게 시키고 있는 편이 나쁘기 때문에, 응츗, 할짝…… 하아, 하아……
んっ、んんっ……ちゅるっ、ちゅっ……んくっ、くぅっ、んっ、ちゅるっ……ちゅるっ、ちゅるっ……んっ、んん～……うっ、ふっ……んくぅっ……	응, 응읏…… 츄룻, 츗…… 응쿳, 쿠웃, 읏, 츄룻…… 츄룻, 츄룻…… 읏, 응응~…… 웃, 훗…… 응쿠웃……
んっ、はぁっ、はぁっ……んちゅっ、ちゅるっ……んはぁっ！　んぅっ、ちゅるっ……ちゅるるっ……はぁっ、んっ、んっ……ちゅるっ……ちゅるっ……！	응, 하앗, 하앗…… 응츗, 츄룻…… 응하앗! 응웃, 츄룻…… 츄루룻…… 하앗, 읏, 읏…… 츄룻…… 츄룻……!
いたずらそうな目で俺を見るのみ。今回は俺に主導権など一切無いのだろう。	장난한 눈으로 나를 볼 뿐. 이번은 나에게 주도권 따위 일절 없을 것이다.
んじゅっ、じゅっ！　んっ、んくっ……はぁっ、はぁっ、んっ、じゅるっ、じゅるるっ……！　んっ、んんぅっ……じゅぅっ、じゅぅぅっ……んふぅっ、んっ！	쥿! 읏, 응쿳…… 하앗, 하앗, 읏, 쥬룻, 쥬루룻……! 읏, 응응웃…… 쥬웃, 쥬웃…… 응후웃, 읏!
ぐちゅぐちゅ……と艶かしい音が響き、唾液と先走りの絡み合った汁が口から零れる。	질척질척…… 와 요염한 소리가 울려, 타액과 앞달리기가 얽힌 국물이 입으로부터 흘러넘친다.
俺は搾り出されるように射精する。	나는 짜 나오도록(듯이) 사정한다.
くうぅんっ！　んむ～……ん～！	먹는 응! 응무~…… 응~!
はぁ、も、もぉっ……何で朝からこんなに濃いの……？　ご主人様って、その……凄いわよね……	후~, 도, 도…… 무엇으로 아침부터 이렇게 진한거야……? 주인 같다는 것은, 그…… 굉장해요……
んぅっ、これがアタシ専用だったらいいのにぃ……んちゅっ、いくらでも口でしてあげてぇ、はぁ、はぁ……	응, 이것이 나 전용이라면 좋은데…… 응츗, 얼마든지 입으로 해 줘어, 하아, 하아……
……まだ、したい？	…… 아직, 하고 싶어?
ん……いいの？　アタシ、ご主人様が喜んでくれるなら、ずーっとしちゃうわよ……？	응…… 좋은거야? 나, 주인님이 기뻐해 준다면, 쭉 해 버려요……?
返事の代わりに、ペニスがひくつく。	대답 대신에, 페니스가 실룩거린다.
ばぁか、ん……しょうがないから、全部出すまで、ん…してあげるぅ……	바보, 응…… 어쩔 수 없기 때문에, 전부 낼 때까지, 응… 해 준다아……
んふ……ご主人様ぁ……今日はいっぱいしてね……？	…… 주인님…… 오늘은 잔뜩 해줘……?
うん、もちろん。そのつもりだよ。	응, 물론. 그럴 생각이야.
やったぁ……あたしもう、うずうずしちゃってるから……いっぱい、きもちよくしてほしいの……	휴…… 나 벌써 하고싶어서 근질근질하고 있으니까…… 잔뜩 기분 좋게 해줬으면 좋겠어……
ね、ねえ……ご主人様……ここで、ちょっとだけ、えっちなことして……？	저, 저기…… 주인님…… 여기서 조금만 야한 거 해줄래……?
ここで？　あと少しで部屋につくのに？	여기서? 조금만 있으면 방에 도착하는데?
う、うんっ……あたしのあそこ、もう濡れちゃって……触って欲しくなっちゃったからぁ……	…… 내 거기가 벌써 젖어 버려서…… 만져주길 원하고 있으니까……
しょうがないなぁ……触るだけだよ？	어쩔 수 없네…… 만지는 것 뿐이야?
んっ……ひぅっ……ご主人様の指ぃ……あ、ん……あったかい……	읏, 히앗………… 주인님의 손가락…… 아, 응 …… 따뜻해……
……本当に濡れてるね。	…… 진짜 젖어있네.
あ、んんっ……そう、なのぉ……あたしのあそこ、期待して……もうとろとろになっちゃってたの……	아…… 그, 그래…… 내 거기는 하고 싶어서…… 벌써 질척질척해져 버렸어……
ご主人様に、可愛がってほしくて……んっ、くぅんっ……ひくひくしてるでしょ……？	주인님에게 귀여움 받고 싶어서………… 움찔움찔 하고 있잖아……?
ひぁっ、ぁぁ、やぁ……恥ずかしいのにっ……あそこも勝手にっ……ご主人様に、甘えちゃってるのっ……んっ、ふぁぁ……	히앗, 아아, 싫어…… 부끄러운데…… 거기가 제멋대로…… 주인님에게 어리광부리고 있어…………
このままイキたい？	이대로 가고 싶어?
問いかけながら、俺は指の動きを速めていく。	물어 보면서 나는 손가락의 움직임을 빠르게 한다.
んくっ……ひぁっ！　うん、イキたいっ……このまま、ご主人様の指で、イカせてほしいのっ……んっ、んぅっ……！	……가고 싶어…… 이대로 주인님의 손가락으로 가게 해줬으면 좋겠어…………!
後でっ、夜伽で、いっぱいお返しのご奉仕するからぁ……このまま、や、ぁぁんっ……！　このまま続けてっ……？　んっ、はぁ……！	나중에 밤시중에서 답례로 잔뜩 봉사할테니까…… 이대로, 싫어 ……! 이대로 계속해줘……? ……
んっ、はぁ、んはぁっ……！　もっと激しくして……あたしの中まで、指でぐちゃぐちゃにしてぇっ……！	…… 좀 더 격렬하게 해줘…… 내 안쪽까지, 손가락으로 엉망진창으로 해줘……!
あぁぁっ、んっくぅっ！　ご主人様の、ゆびぃぃ……あたしの、弱いとこ、擦ってっ、んんんっ！　あたしもう、イ、イキそうなのっ、んんんっ！	아아아앗! 주인님의 손가락…… 내 약한 곳을 비벼서, 나 이제 가, 갈 것 같아!
ほら……イっていいよ。	자…… 가도 좋아.
うん、うんんっ、あ、あたしイクからっ、あぁぁっ！　ご主人様の指で、んっ、んっ……イ、イクっ、イクイクイクっ……んっ、くぅうううんっ！	나, 나 가버리니까, 아아앗! 주인님의 손가락으로…… 가, 가버려, 가, 가, 가……!
あ、あ、あぁああああ～……っ！！　あくっ！　あ、ん、くぁああっ……！	아, 아, 아아아아아아~……!! ……!
はぁぁっ、んっ、ふぁぁ……はぁっ、はぁ…………あたし、こんなにあっけなく……ご主人様に弄られて、イっちゃったぁ……	…… 하앗, 하아………… 나 이렇게 쉽게…… 주인님에게 만져져서 가 버렸어……
はぁ、はぁ……ご主人様の指も……素敵だったぁ……やっぱりあたし、ご主人様がいないともうだめかも……	하아, 하아…… 주인님의 손가락도…… 멋져…… 역시 난 주인님이 없으면 이제 안되겠어……
ね？　続きしよ……お部屋で、もっといっぱい、エッチなことして……あたしをもっとイカせてぇ……？	저기? 계속하자…… 방에서 좀 더 잔뜩 야한 거 하자…… 날 좀 더 가게 해줘……?
そんな熱にあてられてか、もう俺もすっかり滾っていた。	그런 열기에 맞춰진 듯 이제 나도 완전히 달아오르고 있었다.
ご主人様……？　さっきおしゃべりしてた時……よそ見してなかった……？	주인님……? 좀 전에 이야기하고 있을 때…… 곁눈질 하고 있지 않았어……?
あぁ、見たことのないメイドさんがいてね……ちょっと気になっちゃって。	아, 본 적이 없는 메이드가 있어서…… 조금 신경 쓰였어.
なによ、それぇ……どうせエッチな目で見てたんでしょ……？　あたしが一緒にいたのに……	뭐야, 그게…… 어차피 야한 눈으로 보고 있었던 거지……? 내가 같이 있는데……
はは、そんなことはないよ？	하하, 그렇지 않은데?
もぅ……ご主人様ってば、すぐ笑ってごまかすんだから……	정말…… 주인님은 정말 금방 웃으면서 넘어간다니까……
そのまま俺のペニスを取り出して、じっとこちらを見つめてくる。	그대로 나의 페니스를 꺼내고 가만히 이쪽을 바라본다.
あたし以外のこと……エッチな目で見ちゃだめなんだからね？　あたしがここで……ご主人様の、絞りとってあげる……	나 말고 다른 여자를…… 야한 눈으로 보면 안 된다구? 내가 여기서…… 주인님을 짜내 줄게……
ちゅ……ちゅ……れるぅ……はぁ……ほらぁ……あたしの舌、きもちいいでしょ？　ご主人様ぁ……	……………… 하아…… 봐…… 내 입 기분 좋지? 주인님……
んちゅ、ちゅっ……だって、ご主人様が……他の女の子のこと、考えてるなんていやだもん……ちゅっ、ちゅっ……れろぉ……	…… 주, 주인님이…… 다른 여자를 생각하는 건 싫단 말야…………
ちゅ……ご主人様は、みんなに可愛いって言ってるんでしょ……？　そんなの、だめなんだから……全部、あたしがもらっちゃうんだからぁ……	…… 주인님은 모두에게 귀엽다고 말하는 거지……? 그럼 안 되니까…… 전부 내가 받아버릴 거니까……
んぷ、ちゅぷぷっ……！　んっ、んぅっ、んちゅ、じゅぷっ……ごひゅじんひゃまは、あたひのものなんらからぁ……んじゅ、ちゅるるっ……！	………… 주이니믄 내 꺼니까………!
んじゅっ、じゅぷぅ……！　ぜったい、だれにも、あげたりなんてしないんだからっ……んむっ、じゅるる！　んっ、んっ、んっ……！	…… 절대로 아무한테도 안 줄 거니까…………!
いきなりの強烈な快感に、腰がひけてしまいそうになる。	갑작스러운 강렬한 쾌감에 허리가 당겨진다.
ぷぁっ……はぁ……はぁ……ね？　あたしがいちばん、上手くできるんだから……	…… 하아…… 하아…… 저기? 내가 제일 잘 할 수 있으니까……
んふっ……うれしぃ……このまま最後まで、きもちよくしてあげるから……ちゃんと出してね……？	…… 기뻐…… 이대로 끝까지 기분 좋게 해줄테니까…… 제대로 싸야 해……?
あむぅ……んっ、じゅるるっ！　ごひゅじんひゃまぁ……んっ、んじゅっ、じゅぷっ！　しゅきぃ、んっ、しゅきなのぉ……んっ、んんっ……！	…… 주이니임…… 조아해, 조아해…………!
んじゅっ！　んんっ、ごひゅじんひゃまの、ふるえへる、んぷっ、ぢゅ、じゅるるぅっ、もうらひてくれるの？　ん、んぢゅぅうっ！	! 주이님 떠리고 이써…… 이제 나오려느 거야? ……!
ああ、もう……すぐにでも出そうだよ。	아아, 이제…… 당장이라도 쌀 것 같아.
んぅうっ、はやく、はやくいっへぇっ、んじゅっ！　あらひにぜんぶらひてぇっ！　んじゅっ、ぢゅ、ぢゅ、んんっ、ぢゅぅぅっ、んんんんっ！	……빠리, 빠리 싸줘! 나, 나하테 전부 싸줘! ……
熱心な奉仕に、俺はすぐに限界を迎える。	최선을 다하는 봉사에 나는 곧바로 한계를 맞는다.
ん、んぅううう～～っ……！　んんっ！　んぷっ、んっ、くぅ……ぢゅるぅ……	으, 으우우우웃……! ……
んぷっ……くちゅ……にがひ……んっ、くちゅ…………れも、らいひゅき……	…… …… ……………… 그래도 너므 조아……
んっ、んくっ……ん、ごく、んっ……はぁ、はぁ……ご主人様ぁ……いっぱい、だしすぎ……んっ……はぁ……	………… 하아, 하아…… 주인님…… 너무 쌌어…… …… 하아……
はは……溜まってたのかな？	하하…… 쌓여 있었던 걸까?
そんなだからぁ……あたし以外のこと、見ちゃうのよ……そんなの、だめなんだからぁ……	그러니까…… 나말고 다른 여자를 보는 거야…… 그런 건 안된다니까……
今日は、まだまだ……ご主人様のせいえき……全部あたしが絞りとって……浮気できないように、しなくちゃ……	오늘은 아직…… 주인님의 정액…… 전부 내가 짜내서…… 바람피지 못하게 하지 않으면……
……ねぇ、その……ちゅーしてよ、ご主人様……	…… 저기, 그……키스해요, 주인님……
ちゅっ……ちゅっ……んぅっ……もっと……してよ……はぁ、はううっ……ちゅっ……	…… …… …… 좀 더…… 해…… 하아…… ……
はぁ……ちゅっ……れりゅっ……こんな事するの……ちゅっ……ご主人様だけ……だしぃ……ちゅっ……れりゅうっ……	하아……………… 이런 걸 하는 건…… …… 주인님 뿐…… …… …………
俺はちょっと意地悪するように、優しいキスを続けた。	나는 약간 장난스럽게 다정한 키스를 계속했다.
ちゅぷっ……んぅっんっ……好き、好き……アタシ……ちゅっ、れりゅっ……こうしてる時がぁ……一番、いいのぉ……ちゅぷっ……	…… …… 좋아해, 좋아해…… 나……  …… 이렇게 하고 있을 때가…… 제일 좋아…………
でも、ずっとキスしてたら……それ以上の事は……	그치만 계속 키스 하고 있으면…… 다른 일을……
……そうね、はぁ、はぁ……ずっとこうしていたいけど……こんなので、足りるはずないしっ……	…… 그러네, 하아, 하아…… 쭉 이러고 있고 싶지만…… 이런 걸로 충분할 리 없고……
……キスだけじゃ我慢できなくなった？	…… 키스만으로는 참을 수 없게 되었어?
……んぅっ……キスもね、すっごく好きだけどぉ……んっ……それ以上に……はぁ、はぁ……もっと、刺激が欲しくって……	…… …… 키스도 말야, 엄청 좋아하지만…… …… 그 이상으로…… 하아, 하아…… 좀 더 자극을 원해……
ご主人様……お、お願い……その……もっと、もっとエッチな事……アタシに、してよ……	주인님…… 부, 부탁해…… 그…… 좀 더, 좀 더 야한 걸…… 나한테 해줘……
……どうしてほしいの？	…… 어떤 걸 원하는 거야?
……せっくす、よ……はぁ、はぁ……その、せっくすしたいの、ご主人様に……いっぱい、突かれたいの……	…… 섹스 …… 하아, 하아…… 그, 섹스 하고 싶은 거야. 주인님에게…… 잔뜩 쑤셔지고 싶은 거야……
……アタシ、ご主人様と……ずっと触れ合っていたいの、唇でも、アソコでも……はぁ、はううんっ……	…… 나, 주인님이랑…… 쭉 붙어있고 싶어. 입술에서도, 그곳에서도…… 하아……
だから……その……いれてよぉ、んっ……身体の奥までご主人様のモノにしてほしいの……はぁ、はううっ……お願いよ……	그러니까…… 그…… 넣어줘…… 몸 안쪽까지 주인님의 것이 되고 싶어…… 하아…… 부탁이야……
……ああ。	…… 아아.
あああっ……！　はぁ、はひっ、ご主人様、ご主人様ぁ、う、嬉しい、いれてくれたぁ、はぁ、はうううっ……！	아아앗……! 하아, 주인님, 주인님, 기, 기뻐, 넣어 주었어, 하아……!
んぅ、ん、くっ……！　ご、ご主人様ぁ、アタシ、はぁ、はううっ……！　アタシ、ご主人様のモノになってるのぉ、はぁ、はひっ！　くぅううんっ！	…… 주, 주인님, 나, 하아……! 나 주인님의 것이 된 거야, 하아……!
声が大きいよ……誰か、きちゃうかもね？	목소리가 커…… 누군가 올지도 몰라?
はぁ、はううっ、んぅっ！　ど、どうでもいいのぉ、んっ！　はひっ、はううっ……！　ご主人様とできるなら、ああ、はぁああんっ……！	하아……! 아, 아무래도 좋아……! 주인님이 들어와준다면, 아아……!
んぅっ、ん、くぅうっ……！　アタシ、ご、ご主人様しか、はぁ、はぁ、興味、無いからぁ、はぁ、はううっ！	…… 나, 주, 주인님 밖에, 하아, 하아, 관심 없으니까, 하아……!
夢中になっちゃって。	푹 빠져버렸네.
……けど、これだけ淫らだと、他のお客様に気付かれてしまう可能性が高くなってしまう。	…… 하지만 이만큼 음란하다면 다른 손님들이 알아볼 가능성이 높아진다.
早く、終わらせよっか。	빨리 끝낼까.
あううっ、アタシ、酔ってぇ、はぁ、はぁああっ！　もうわけ、わかんなく、なっちゃってるからぁ！	아우웃, 나, 기분좋아, 하아, 하아아앗! 이제 뭐가 뭔지 모르겠어!
はぁ、はぁ、もっとついて、突いてよぉ、はぁ、はううっ！　アタシのこと、しあわせにしてぇ、はぁ、はぁ、いっぱいついて、一番、奥ぅっ！	하아, 하아, 좀 더 들어와, 쑤셔줘, 하아, 하우웃! 나를 행복하게 해줘, 하아, 하아, 잔뜩 들어와줘, 제일 안쪽에!
このままぁ、して、出して、出してぇ、はぁああっ！　膣内がいいのぉ、はぁ、膣内じゃないと、い、いやなのぉっ！　んんん～～っ！	이대로 해, 싸, 싸줘, 하아아앗! 질내가 좋아, 하아, 질내가 아니면 시, 싫어! 
激しい抽送に、俺もすぐに限界を迎える。	격렬한 반응에 나도 곧바로 한계를 맞이한다.
あうっ、イっちゃうぅっ！　ひぐっ、んぅっ！　イっちゃううっ、も、もっとしたいのにっ、でも、でも、最後まで、してほしいし、あうううっ！	가 버려, 가 버려! 조, 좀 더 하고 싶은데, 그치만, 그치만, 끝까지 해 줬으면 좋겠어……!
あう、ご主人様、ご主人様ぁ、はぁ、はぁ、アタシにもっと、はぁあ、ぱんぱんってしてぇ、はぁ、はぁ、んぅ～～～っ！	주인님, 주인님, 하아, 하아, 나에게 좀 더, 하아아, 푹푹 해, 하아, 하아……!
んっ……あひっ、ひゃぁあああああ～～～～～っ！！	…… 햐아아아아아앗!!
ああああ……はぁああ……はひっ……ひぃいっ……よかったぁ……はぁ……はううっ……すっごく、良かったのぉ……くぅうううんっ……	아아아아…… 하아아아…… …… …… 좋았어…… 하아………… 엄청 좋았어…………
…………あううっ……したことは、したけど……はぁ、はううっ……まだ、足りないかもぉ……ふふっ……	………… …… 하긴 했지만…… 하아…… 아직 부족할지도…… 후훗……
……ふふっ……まだ……今日はいっぱいできるのよね……こんなに幸せで……アタシ、いいのかな……？	…… 후훗…… 아직…… 오늘은 잔뜩 하는 거네요…… 이렇게 행복하다니…… 나 괜찮을까……?
ん……あぅぅ……ご主人様ぁ、あたし、頭ふわふわして……からだもあつくなってるの……	…… …… 주인님, 나 머리가 어질어질해…… 몸도 뜨거워지고 있어……
あたしのからだ、さわって……？　ちょっとだけでいいからぁ……	내 몸, 만져줄래……? 조금만이라도 좋으니까……
あと少しだから、部屋まで頑張って。	거의 다왔으니까 방에 갈때까지 참아.
やぁ、やぁん……ご主人様のいじわる……もう、我慢できないのに……	시, 싫어…… 주인님 짓궂어…… 이제 못 참겠는데……
じゃあ……見ててあげるから、自分で慰めればいいんじゃない？	그럼…… 보고 있을테니 자위하면 되잖아?
んく……いいの？……こんなところで、自分でしちゃっても、いいの……？	…… 괜찮아? …… 이런데서 해버려도 괜찮아……?
したくなっちゃったなら、しょうがないんじゃない？	하고 싶어졌으면 어쩔 수 없잖아?
うん……そうよね……我慢できなくなっちゃったんだからぁ……しょうがないよね……	응…… 그러네…… 참을 수 없게 됐으니까…… 어쩔 수 없네……
あ、んっ……ほら、見てぇ……あたしのここ、もうこんなに、濡れちゃってる……んは、あぅっ……	아…… 저기, 봐…… 내 여기 벌써 이렇게 젖어 버렸어…… ……
……いつから濡れてたの？	…… 언제부터 젖어있었던 거야?
はぁ、んぅ……ずっと、ずっと前から……お酒飲みはじめて、すぐ……んっ、んぁ……あたし、濡れちゃってたのぉ……	하아…… 쭉, 훨씬 전부터…… 술 마시고 바로………… 나 젖어 있었어……
さっきからずっと……んっ、ふぁっ……あ、歩くのも、つらかったんだからぁ……ん、ぅぅっ……	아까부터 계속…… …… 거, 걷는 것도 힘들었으니까…………
んくぅん……だって、だってぇ……ご主人様がしていいって言うからぁ……あ、あたしは悪くないんだからぁ……	…… 그치만, 그치만…… 주인님이 해도 된다고 말했으니까…… 나, 나는 나쁘지 않으니까……
だ、だからぁ……んっ、くぅ……ゆ、指がきもちいいからぁ……もっと、激しくしても、いいよね……？　んっ、ああっ……	그, 그러니까…… …… 소, 손가락이 기분 좋으니까…… 좀 더 격렬하게 해도 되지……? ……
はぅ、んっ、ああっ……ご、ご主人様ぁ……きもちいいのぉ……あくっ、アソコ、自分で弄って、きもちよくなっちゃうのぉ……！	…… 주, 주인님…… 기분 좋아……  거기 스스로 비틀어서 기분 좋아져 버려……!
早くしないと、誰か来ちゃうよ？	빨리 하지 않으면 누군가 온다구?
ひぁっ、あっ、待ってっ……！　こ、こんなところ、見られたら……ぜったい、変態だって思われちゃうっ、んっ、あぁぁっ……！	……안돼……! 이, 이런 걸 보여지면…… 무조건 변태라고 생각할 거야……!
あ、あたし、すぐ、イクからぁっ……あっ、んんっ……！　イっていいよね？　んっ、ふぁ、んぅっ、最後まで、しちゃってもいいよねっ……？	나, 나, 이제 갈것 같으니까…… ……! 가도 되지? 끝까지 해 버려도 되지……?
いいよ。見ててあげる。	좋아. 보고 있어 줄게.
あはっ……んぅ、んひぃぃっ！　ここぉ、クリトリスがいいのぉ！　あたし、ここ弄ったら、すぐにイッちゃうからぁっ！	…… 여기 클리토리스가 좋아! 나, 여기 만지작거리면 금방 가버리니까!
んぁ、ああっ！　だめぇ、こんなところで、もうっ……だめぇ！　んくっ、あっ、んは、ぁああっ！	아앗! 안돼, 이런 곳에서, 정말 …… 안돼! 앗, 아아앗!
ご主人様ぁ！　あたしが、オナニーで、はしたなくイクところ見ててぇっ！　んぅううっ、んひ、イクっ、イっちゃうぅ……んっ、あああぁっ！	주인님! 내가 자위로 부끄럽게 가버리는 걸 봐줘! ……가, 가버려…… 아아아앗!
あ、あ、あっ……！　んっ、あぁああああぁぁぁっ……！！	아, 아, 앗……! 아아아아아아앗……!!
あくっ……んひ、ひぁんっ……！　はぁっ、はぁっ……んんっ、はぁ…………お酒と、オナニー……くせになっちゃう……	…… 하아………… 술이랑 자위…… 버릇이 돼버려……
や、ぁん……ちょっとだけ、休ませて……まだ、腰が震えてるんだからぁ……	싫어…… 조금 쉬게 해줘…… 아직 허리가 떨리고 있으니까……
だめだよ。この後で夜伽もしてもらうんだからさ。	안돼. 나중에 밤시중도 받을 거니까 말야.
ご、ご主人様ったらぁ……ほんとに、いじわるなんだからぁ……んくっ……やぁ……お汁、たれてきちゃったぁ……	주, 주인님도 참…… 정말 심술궂다니까…… …… 싫어…… 애액이 축 늘어져 버렸어……
ご主人様ぁ……先に行ってて？　アタシちょっと、お手洗いに行ってくるから……	주인님…… 먼저 가있을래? 나 잠깐 화장실 좀 다녀올테니까……
おしっこ、したいの？	오줌누고 싶은 거야?
え、えぇ……そう、だけど……？……な、なんでそんなこと聞くの……？	으, 응…… 그런데……? …… 왜, 왜 그런 걸 묻는 거야……?
いや……ここですればいいんじゃない？	아니…… 여기서 하면 되는 거 아냐?
やぁ……だめ、だめよそんなの……は、はしたないじゃない……	싫어…… 안돼. 안 돼, 그런 거…… 부, 부끄럽잖아……
汚しちゃうし……だれかにみられたら、変態みたいじゃない……	더럽고…… 누군가에게 보여지면 변태가 되잖아……
あ、んぅ……あ、アタシは、ご主人様以外には、そんな風に思われたくないもん……見ていいのは、ご主人様だけなんだからぁ……	…… 나, 나는, 주인님 외에는 그런 식으로 생각되고 싶지 않은 걸…… 봐도 되는 건 주인님뿐이니까……
まんざらでもなさそうな反応に、俺はさらに促していく。	그리 싫지만도 않은 것 같은 반응에 나는 한층 더 재촉해 간다.
じゃあほら、俺に見せてよ。	그럼 자, 나한테 보여줘.
あ、んぅっ……そこまで言うなら……ちょっとだけ……	아…… 그렇게 말한다면…… 조금만이야……
やだ、ぁん……なんか、スースーして……ドキドキしちゃう……アタシ、こんなところで、おしっこしようとしてる……	싫어…… 뭔가 으스스해…… 두근거려…… 나 이런데서 오줌누려고 하고 있어……
ご、ご主人様ぁ……そんなに見られたらぁ……あ、アタシ恥ずかしくて、おしっこ出ないの……	주, 주인님…… 그렇게 보고 있으면…… 나, 나 부끄러워서 오줌이 나오지 않아……
それじゃあ意味ないから……ちゃんと全部見せてね？	그럼 의미 없거든…… 제대로 전부 보여줄래?
そ、そんなぁ……ご主人様のえっち、いじわるっ……	그, 그런…… 주인님은 야해, 나빠……
ほら、早くしないと、エッチな汁まで垂れちゃってるよ？	자, 빨리 안하면 야한 즙까지 떨어져 버릴 거야?
はぅ、んくぅ……だって、ご主人様が見てるからぁ……ご主人様に見られたら、アタシ、濡れちゃうんだからぁ……は、ぁんっ……	…… 그치만 주인님이 보고 있으니까…… 주인님에게 보여지면 나 젖어 버리니까…………
……あ、あ、だめ……お、おしっこ、出そう……や、やぁ……あ、アタシ、やだ、あぁっ……！	…… 아, 아, 안돼…… 오, 오줌, 나올 것 같아…… 시, 싫어…… 나, 나, 싫어, 아아아아앗……!
あっ……！　や、あ、出てる、んっ、んんんんん～～～っ……！！	앗……! 싫어, 아, 나오고 있어……!!
んぁぁ、は、ぁぁ……ん…………あ、アタシ、こんなところで、おしっこしちゃったぁっ……ん、ふぁぁっ……	………… 나, 나 이런데서 오줌 눠 버렸어…… ……
生々しい、ツンとした香りが鼻につく。	생생하네. 찡한 냄새가 코를 찌르네.
ずいぶん、いっぱい出たね？	꽤나 잔뜩 나왔네?
やぁん……お酒、いっぱい飲んだからぁ……はぁ……はぁ……ねぇ、ご主人様……アタシ、可愛かったぁ……？	싫엉…… 술을 많이 마셔서…… 하아…… 하아…… 저기, 주인님…… 나 귀여웠어……?
ああ……すっごく興奮したよ。	아아…… 엄청 흥분했어.
んふっ……よかった……アタシもね？　ご主人様に見られてするの、よかったかもっ……ふふっ……	…… 다행이다…… 나도 말야? 주인님에게 보여지는 거 좋았을지도…… 후훗……
この後の夜伽に向けて、俺の期待も高まっていった。	이 뒤의 밤시중을 하러 가면서, 나의 기대도 높아지고 있었다.
ご主人様、あのね……お、お願いがあるんだけど……	주인님, 저기…… 부, 부탁이 있는데……
我慢できなくなっちゃった？	못 참게 됐어?
ここで、キスしてほしいの……ちょっとだけでいいから……	여기서 키스해줬으면 좋겠어…… 조금이라도 좋으니까……
うん、わかったよ。	응, 알았어.
ちゅっ……んっ……ご主人様ぁ……ちゅっ、ふふっ……大好き……んっ……ちゅ、ちゅっ……	…… … 주인님………… 너무 좋아……………
あとちょっとで部屋なんだけどなぁ……	조금만 더 가면 방인데……
いいでしょ……？　んちゅっ、ちゅ……アタシは今、したかったんだから……ちゅっ……んぅ……ちゅぅ……	괜찮잖아……? …… 난 지금 하고 싶으니까…… ………… ……
ご主人様ぁ……ちゅっ……れろっ……ん、ちゅっ……ご主人様とのキス、ちゅっ、好きなの……んっ……ちゅっ、ちゅっ……	주인님…… …… …… …… 주인님과의 키스, 좋아해…… …………
ねぇ……だからもっと……エッチなキス、して？	저기…… 그러니까 좀 더…… 야한 키스, 해줘?
あぁ、んちゅるっ……んちゅる、じゅるるっ、れるぅっ……ご主人様ぁ……んんっ……これぇ……エッチなキス、好きぃ……	아아………… 주인님…… …… 이거…… 야한 키스, 좋아……
ご主人様の、くちびるも、舌も……んちゅ、じゅるぅ、んちゅぅ……ずっと味わっていたいのっ……んっ、ちゅ、ちゅ……	주인님의 입술도 혀도…… …… 계속 맛보고 싶어…………
唇を舐め上げ、唾液をすすり、蕩けた瞳はまるで熱に浮かされたかのよう。	입술을 핥고 타액을 마시고, 녹아버린 눈동자는 열에 들뜬 것 같다.
ねぇ、もっと……アタシのこと、キスで溶かして……？　んっ、ちゅっ、ちゅぅ……	저기, 좀 더…… 나를 키스로 녹여줘……? ……
ちゅ、んっ、ちゅっ……じゅるっ、ちゅ、れろぉ…………すごい、キス……気持ちいいよぉ……	…… ………… 대단해, 키스…… 기분 좋아……
……このまましちゃう？	…… 이대로 할까?
だめ、んっ……だめよ、こんなところじゃ……恥ずかしいんだから……	안돼 …… 안돼, 이런 곳은…… 부끄러우니까……
エッチなキスは求めてきたのに？	야한 키스는 원했으면서?
だって……だって我慢できなかったんだもん……ねぇ、早くお部屋行こ？　もっといっぱい、キス以外のこともしていいからぁ……	그치만…… 그치만 참을 수 없었단 말야……저기, 빨리 방에 가자? 좀 더 잔뜩, 키스 말고 다른 걸 해도 좋으니까……
唇が離れてもその身をすり寄せてくる。	입술이 떨어져도 그 몸을 갖다대 온다.
ここで始めてしまうのも一興だけど、俺はひとまず部屋に急ぐのであった。	여기서 해 버리는 것도 흥미롭겠지만, 나는 일단 방으로 가는 것을 서두르는 것이었다.
ご主人様、ちょっと動かないでね……	주인님, 잠깐 움직이지 말아줘……
いいでしょ？　ご主人様のこと、ちゃんと気持ちよくしてあげるから……	괜찮지? 주인님을 확실히 기분 좋게 해줄테니까……
ちゅ……んちゅっ……れろぉっ……それにほら、ご主人様も、もう大きくしてるじゃない……	…… …… …… 그리고 봐, 주인님도 벌써 커져 있잖아……
シャワーまだなのに……	샤워 아직인데……
んちゅ、ちゅるぅ……たしかに、ちょっと……濃い味がするけど……ちゅっ……平気よ、こんぐらい……ん、ちゅぅぅ……	…… 확실히 조금…… 진한 맛이 나지만…… …… 괜찮아, 이정도는…………
それより、ご主人様の……熱くて、硬くて……やっぱり、素敵……ちゅ、ちゅっ……んっ……あむっ……	그거보다 주인님의 거기…… 뜨겁고 단단해서…… 역시 멋져…… …… …………
ちゅぷぷっ……んじゅ、ぢゅっ、ぢゅるぅっ……ね、気持ちよくなって、いいから……んちゅ、ちゅっ、じゅるっ……	…… …… 저기, 기분 좋아져도 되니까…………
ご主人様の……んちゅ、んっ……アタシが勝手に咥えるだけだからぁ…………んむっ、ちゅっ、ぢゅるるぅ……！	주인님의 거기…… …… 내가 마음대로 물고 있을 뿐이니까………… ……!
んじゅっ、んっ、んっ、じゅるっ……！　ごひゅじんひゃまの、先っぽからおひるれてきたぁ……んちっ、ちゅっ、ちゅぅぅぅ……	…… 주이니메 끄테서 뭐언가 나와써…… ……
ちゅるんっ、はぁ、はぁ、んぢゅ、ちゅぅ……あたひのおくひ、気持ひいい？　んちゅ、じゅ、はぁ、はぁ、ん、じゅるっ、んんっ！	…… 내 입안 기분 조아? ……!
ああ、気持ちいいよ……	아아, 기분 좋아……
んふっ、んじゅ、もっと、きもひよくなっへっ、はぁ、はぁっ！　んぢゅる、んんっ！　もっとぉっ……！	좀 더, 기분 조아져, 좀 더……!
腰が砕けそうな快感に、少し情けないけれど、すぐに精液が込み上げてくる。	허리가 부러질 것 같은 쾌감에, 좀 한심하지만 바로 정액이 울컥거려 온다.
んぢゅ、ぢゅっ、ぢゅるっ、ごひゅじんひゃまのっ、んぐ、あばれへる、んぢゅる、んっ、んっ、んじゅるるっ、あ、あたひのおくひに、らひてぇ！	……주인니메 날뛰는 정자들 내 입안에 싸줘!
ごひゅじんひゃまのっ、せいえひ、あたひに、のまへて、んぢゅぅぅっ！　いっぱいらひてぇっ、んっ、んじゅっ、んじゅっ、んっ、んんんっ！	주이니메 정액 가득 싸줘 ……
んじゅ、んっ、んぅううううっ……！　んくっ……んっ……ぢゅるっ、れろぉ……れたぁ……ごひゅじんひゃまの……あふいの……ちゅるっ……	…… …… …… ……나와써…… 주인니메…… 뜨거운…… ……
ん、んん……んくっ、ん…………はぁ、はぁ……の、飲んじゃった……んぅ……	…… ………… 하아, 하아…… 머, 먹어 버렸어…… ……
んくっ……ど、どうしよう……ご主人様の、精液飲んだら、アタシ……んっ……やだ、身体疼いてきちゃったぁ……	…… 어, 어쩌지…… 주인님의 정액을 먹었더니 나…… …… 싫어, 몸이 달아올라 버렸어……
うん……部屋に移動しよう。	응…… 방으로 이동하자.
俺だってまだまだ、このままじゃ物足りない。	나도 아직 이대로는 부족하다.
うんっ……ご主人様ぁ……アタシのことも、いっぱい可愛がってね……？	응…… 주인님…… 나를 잔뜩 귀여워해줘……?
ねぇ……ご主人様ぁ……キスして……？	저기…… 주인님…… 키스해줘……?
ちゅっ……んっ……ちゅ……ごめんね、ご主人様……アタシ、全然我慢できないの……	…… …… …… 미안해, 주인님…… 나, 정말 못 참겠어……
んちゅっ……じゅるっ……ちゅ、ちゅ……アタシ、だめかも……キスだけじゃ、物足りない……	…… …… …… 나, 안될 것 같아…… 키스만으로는 부족해……
ご主人様ぁ……アタシ、もう……ご、ご主人様のが、ほしくなっちゃって……だから、ね？	주인님…… 나 이제…… 주, 주인님의 거기가 갖고 싶어져버렸으……니까?
こんなところでいいの？	이런데서 괜찮은 거야?
いいのっ……アタシ、夜伽に誘われたときから……その、早くしたくてたまらなかったんだから……	괜찮아…… 나, 밤시중에 불렸을때부터…… 그, 빨리 하고 싶어서 참을 수 없었으니까……
だから……アタシのアソコ、ご主人様ので、埋めてほしいの……	그러니까…… 나의 저기, 주인님의 것으로, 묻기를 원하는거야……
……ほらぁ……アタシ、もう……こんなになっちゃってるんだからぁ……	…… 자…… 나, 이제…… 이렇게 되어 버렸으니까……
……部屋に行ってからじゃだめなの？	…… 방에 가서 하면 안돼?
だめ、だめなの……意地悪しないで、入れて……？　ね……？	안돼, 안된다구…… 심술부리지 말고 넣어……? 응……?
うぅ……ご主人様の熱いの、ほしいの……アタシとセックスして……んく…………お願い、お願いだからぁ……	…… 주인님의 뜨거운 걸 갖고 싶어…… 나랑 섹스 해…… ………… 부탁해, 부탁이니까……
も、もう待てないのっ……アタシのはしたないアソコに、ご主人様の入れてくれないと……アタシ、おかしくなっちゃうからぁっ……！	이, 이제 못 기다려…… 내 부끄러운 곳에 주인님의 거기를 넣어 주지 않으면…… 나 이상해져 버릴 거야……!
しょうがないなぁ……	어쩔 수 없네……
そのまますぐに、俺は激しく腰を動かし始める。	그대로 나는 격렬하게 허리를 움직이기 시작한다.
ふぁぁっ……！　あっ、やった、ああ、んっ……！　ご主人様の、入ってきたぁ……はぁ、あっ、んんっ……！	…… 앗, 됐다……! 주인님이 들어 왔어…… 하아……!
んぁあっ、あ、しかも、いきなりこんなに激しいなんてぇっ……！　んっ、んくぅん、ああっ……！	그런데 갑자기 이렇게 격렬하다니……! ……
すごい濡れてたからね。激しくしてほしいのかなって。	엄청 젖어 있었으니까. 격렬하게 해줬으면 하는 건가 싶어서.
あぅ、あっ、んんっ……！　そう、そうなのっ……あ、アタシ、ご主人様にキスされて、いっぱい濡らしてたのっ……！	…… 그, 맞아…… 나, 나 주인님에게 키스받아서 잔뜩 젖었어……!
はぁ、はぁっ……こ、こんなエッチなメイドで、ごめんなさいぃ……んっ、くぅ、あぁっ……！　ご主人様の熱いっ……！	하앗…… 이, 이런 야한 메이드라서 미안해…………! 주인님의 거기 뜨거워……!
抽送を始めたばかりなのに、愛液が隙間からどんどん溢れてくる。	삽입을 시작한 직후인데도, 벌어진 곳에서 애액이 계속 흘러넘친다.
ごめんなさい、んっ、んっ……！　こんなところでおねだりして、ごめんなさいっ……でもっ、んんんっ……ああぁっ……！	미안해……! 이런데서 졸라서 미안해…… 그래도…… ……!
ご、ご主人様の、気持ちいいのぉっ！　太いので、奥まで、ずんずんってっ……！　あっ、あぁ、んぁああっ！	주, 주인님의 거기 기분 좋아! 굵어서 안쪽까지 찔꺽찔꺽……!
あん、んっ、ひぁぁっ！　あ、アタシ、エッチなのっ……ご主人様のが、好きで、もうだめになっちゃってるのっ、んっ、んっ、んくぅ！	……나, 나, 야한 거야…… 주인님의 거기가 좋아서 이제 안될 것 같아…… ……!
だからっ、あっ、あっ……ああんっ！　アタシのアソコ、いっぱい突いてぇ！　ご主人様の、熱いの、アタシに出してぇっ……！	그니까……! 내 거기 잔뜩 쑤셔줘! 주인님의 뜨거운 걸 나한테 싸줘……!
興奮は一気に高まって、俺もすぐにでも射精したい欲求に駆られる。	흥분은 단번에 높아져서, 나도 당장이라도 사정하고 싶은 욕구에 사로잡힌다.
ああっ、んっ！　ご主人様の、びくびく震えてっ、ん、はぁ、はぁっ！　アタシの、んっ、中に出してっ、いっぱい熱いのっ、出してぇっ！	 ……주인님의 거기 움찔움찔 떨려, 하아, 하앗! 내 안에 싸줘, 잔뜩 뜨거운 걸 싸줘!
ご、ご主人様ぁっ！　あっ、んく、あっ……んぁあっ、あぁあああああっ……！！　	주인님! …… 아아아아아아앗……!!
んぁあっ、んっ、くぅ……ご、ご主人様の……熱いの、出てる……ん、くぅ！	…… 주, 주인님의…… 뜨거운 게 나오고 있어……!
はぁっ、はぁ……ご主人様ので、アタシの中、いっぱいに……や、ぁん……溢れちゃう……	하아…… 주인님으로 내 안이 가득…… 시, 싫어…… 흘러넘쳐버려……
……あ、あのね、ご主人様……？　我がままに付き合ってもらって嬉しいんだけど、その……	…… 저, 저기, 주인님……? 내 말을 들어줘서 기쁘지만, 그……
アタシ、まだまだ……もっとエッチしたいから……お部屋に行ってからも、ね？　お願い……	나, 아직도…… 좀 더 섹스하고 싶으니까…… 방에 가서도 부탁해……
またもや、俺はこの魅力に逆らえそうになかった。	이번에도 나는 이 매력을 거스를 수 있을 것 같지 않았다.
どうかした？	무슨 일이야?
ねぇ、ご主人様…………ここで、アタシのこと苛めて……？	저기, 주인님………… 여기서 날 괴롭혀 줄래……?
……ご主人様のを、お口に突っ込んで……気持よくして……？	…… 주인님의 것을 입에 넣어서…… 기분 좋게 해주면……?
あ、アタシ……ご主人様と一緒にいるだけで、妄想が止まらなくって……ご主人様の、欲しくてたまらないの……	나, 나…… 주인님이랑 같이 있는 것만으로도 망상이 멈추지 않아서…… 주인님의 거기를 갖고 싶어서 못 참겠어……
ね？　アタシのお口使って、気持ちよくなって……乱暴にしていいからぁ……	응? 내 입을 사용해서 기분 좋아져…… 난폭하게 해도 되니까……
んぷっ、んぢゅぅ……んぐっ、んぅうう……そ、そうなの……あたひ、えっひなめいろなのぉ……んぐ、んぉ、んんぅ……	………… 그, 그런…… 난 야한 메이드야…………
んっ、はぁっ……んぶぅ……ごひゅじんひゃまの、おいひくへぇ……ふぐにくわえひゃくなっひゃうの……ず、ぢゅるるっ、んんんっ……！	………… 주이니메 꺼 마시써…… 계속 물고 시퍼져…………!
んぐっ、んんん……！　はぁ、はぁ……うれひい、こんなに、おっひくひてくれへっ……んぷ、んっ、ぢゅぶっ、んんっ！	…… 하아, 하아…… 기뻐어 이러케 크게 돼서…… !
もっほぉ……んぐ、んぢゅぅぅぅっ！　んぶっ、んぉ、んんん……もっほおくまれぇ……んっ、んぷっ、んぅうんっ……！	…… …… 좀 더 안쪽까지…………!
んぅううっ……！　ご、ごめんひゃいぃ……あらひ、ごひゅじんひゃまに、無理矢理されへ、感じひゃうろぉ……んぐ、んぅ、んんん～～っ……！	…… 미, 미아해…… 나 주이니메게 무리하게 당해서 느껴버려…………!
んぐっ、んぶぅ！　んっ、ごひゅじんひゃまの、ぐぶ、く、くるひぃっ……！　んぐぅ、ぅぇええっ、んんんっ！	 ……주이니메 거기, 괴, 괴로워……! ……!
ほらっ、これがいいんだろ？	자, 이게 좋은 거지?
んぅうんっ！　んぐっ、んんんぅっ、いいぃ、いいろぉっ！　んぢゅる、んぶ、うぇ、んぐぅぅっ！	……조, 좋아, 좋아! ……!
ごひゅじんひゃまろ、らしてぇ！　このまま、のどのおくれぇ！　んぐ、んぷ、じゅる、んっ、んっ、んっ……んんんん～～～っ！！	주이니메 하얀 거! 이대로 입안에 쏟아내줘! ……!!
んぶぅっ！？　んっ、んぐんんっ……！　んっ！	……!? ……읏!
ほら……吐き出さないで。	이봐…… 뱉어내지 마.
んんっ……んく、んっ……ごくっ、ん…………はぁ、はぁ……喉、熱い……	…… …… 꿀꺽………… 하아, 하아…… 목이 뜨거워……
ご主人様ぁ……ありがとうございます……こんなアタシに、精液いっぱいくれて……	주인님…… 감사합니다…… 이런 나에게 정액을 잔뜩 줘서……
早く立って、部屋行くよ。	빨리 일어서, 방으로 간다.
は、はぁい……んっ……もっと……もっといっぱい、アタシのこと使ってくれたら嬉しいの……♪	네, 네에…… …… 좀 더…… 좀 더 잔뜩 나를 사용해 주면 좋겠어……♪
その姿に、俺はまた自分が昂っていくのを感じた。	그 모습에 나는 또 자신이 흥분하는 것을 느꼈다.
ご主人様ぁ……あのね、お願いが……あるんだけど……	주인님…… 저기, 부탁이…… 있는데……
……ここでしろって？	…… 여기서 하자고?
そう、お願い……もう、お部屋まで待てないからぁ……	그래, 부탁해…… 이제 방에 갈때까지 못 기다리겠으니까……
もう少し待てないの？	조금만 더 기다릴 수는 없어?
も、もう無理ぃ……ご主人様の入れてほしくて、アソコ、疼いちゃってるんだからぁ……	이, 이제 무리…… 주인님을 넣어 달라고 거기가 간절히 원하고 있으니까……
だから、その……早く、入れて……？　ご主人様の、太いので……アタシのここ、滅茶苦茶に擦ってほしいの……	그니까 그…… 빨리 넣어줘……? 주인님의 거기 굵으니까…… 내 거기 엉망으로 해줬으면 좋겠어……
俺のほうはその言葉を聞いて、もう準備が整っていた。	내 쪽은 그 말을 들었을 때, 이미 준비가 되어 있었다.
んはぁああっ……！　はぁ、んぅん……ご、ご主人様の、入ってきたぁ……あぁんっ……	…… 하아…… 주, 주인님이 들어 왔어…………
ふぁ、あっ……はぁ、はぁ……や、おっきぃ……んく、んっ……いれられるだけで、お汁、溢れちゃうぅ……	…… 하아, 하아…… 싫어, 커…… …… 넣어지는 것 만으로도 애액이 흘러넘쳐 버려……
んくっ、あぁ……ごめんなさい、こんな、エッチなメイドでぇ……ご主人様に、我がまま言ってぇ……	아아…… 미안해, 이런 야한 메이드라서…… 주인님에게 제멋대로이고……
んぁ、あっ、んくぅん……アタシ、ご主人様に、乱暴にされるの好きなのっ……こんなところでも、ご主人様の、求めちゃうのぉっ……	…… 나 주인님에게 난폭하게 당하는 걸 좋아해…… 이런데서도 주인님을 원해버리는 거야……
いやらしいメイドには、お仕置きしないと、なっ！	음란한 메이드에게는 벌을 주지 않으면 안되겠네!
ひぁっ……！？　あ、んんんっ……！　ご、ご主人様ぁ、は、ああっ……ご、ごめんなさいっ……んくぅ、んんっ……！	………… 주, 주인님…… 미, 미안해…… ……!
んぁっ、ああっ……アタシ、お尻叩かれて、ひんっ！　よ、喜んじゃってるのぉ……んぅっ！　はぁ、はぁっ……んんっ……！	아앗…… 나 엉덩이 맞으면서…… 기, 기뻐하고 있어…… ! 하아…………!
……これじゃあ、お仕置きにならないな……	…… 이래서야 벌이 되지 않네……
やぁ、んんっ……やめないでぇ……もっと、激しく……突きながら、お尻叩いてぇ……	싫어…… 그만하지 마…… 좀 더 격렬하게…… 쑤시면서 엉덩이 때려줘……
お願いだからぁ……んっ、アタシのお尻ぃ、もう熱くなってるから……ご主人様の手で、もっと真っ赤にしてぇ……！	부탁이니까…… 내 엉덩이 이제 뜨거워지고 있으니까…… 주인님의 손으로 좀 더 빨갛게 해줘……!
あくっ、あぅ、んぁっ、き、気持ちいいけど、物足りないのぉ……！　お願い、お願いだからぁ……！	……기, 기분 좋은데, 아직 부족해……! 부탁해, 부탁이니까……!
あひっ！　んっ、ひゃぅんっ、だって、だってぇ……んひっ、ああっ！　痛いの、好きなんだものっ、あっ、んくぅ、あうぅっ！	……그치만, 그치만…… 아앗! 아픈 걸 좋아한단 말야……!
アソコ、突かれて、んっ、んぁあっ！　お尻、お尻もひりひりしてっ……！　熱っ、んくっ、ああっ、んぁああっ……！	거기 쑤셔져서……! 엉덩이, 엉덩이도 얼얼해……! 뜨거워, 아앗, 아아앗……!
腰の動きは緩めずに、尻を思い切り叩き続ける。	허리의 움직임을 늦추지 않고, 엉덩이를 마음껏 때린다.
んくぅぅんっ！　ご主人様、ご主人様ぁっ！　叩いてくれてっ、アタシ、嬉しいのっ、んっ、あぎっ、くっ、あああっ！	……주인님, 주인님! 때려줘서 나, 기뻐…… 아아앗!
ご主人様も、ひんっ、アタシで、気持よくなってっ！　あたしに、全部ぶつけてぇ！　んくっ、あっ、あっ、ああっ、んっ……んんんっ……！	주인님도…… 나로 기분 좋아져! 나한테 전부 와줘! ……아, 아앗…………!
あひっ、ひんっ！　あ、アタシも、いっ、イクっ……！　お尻叩かれて、イッちゃうからっ、んぁ、んっ、んっ……んっ、んぁあああっ！	……나, 나도, 가, 가버려……! 엉덩이 맞으면서 가 버려, …………아아아앗!
最後に勢いよく手の平を叩きつけて、そのまま膣奥に射精する。	마지막으로 힘차게 손바닥을 내려치고, 그대로 질 내에 사정한다.
んぁ、あぁああああっ……！　あひっ、んっ、んんん～～っ……！	아아아아아앗……! ……
ああ、はぁっ、んっひぃ…………はぁっ、はぁ……お尻も……中も、いっぱいで……熱いぃ……ん、んぅぅん……	아아, 하앗………… 하앗, 하아…… 엉덩이도…… 안쪽도 잔뜩…… 뜨거워…………
はぁ……俺ももう手が痛いよ……	하아…… 나도 이제 손이 아파……
ご、ごめんなさい、ご主人様……でも、気持ちよかったの……	미, 미안해, 주인님…… 그래도 기분 좋았어……
ああ……早く部屋で、続きしなくちゃ。	아아…… 빨리 방에서 계속해야겠지.
え、えぇ……その、ありがとうね？　ご主人様……いつもアタシのお願い、聞いてくれて……	으, 응…… 그, 고마워? 주인님…… 언제나 내 부탁을 들어 주니까……
それでも俺は、まだまだこれで終わらせるつもりなんて全然無かった。	그래도 나는 아직 이것으로 끝낼 생각 따위 전혀 없었다.
……何か、下半身が凄く気持ち良い。	…… 뭔가, 하반신이 굉장히 기분 좋다.
蕩けるような甘い感触に、俺は意識が覚醒していく。	녹는 것 같은 달콤한 감촉에, 나는 의식이 각성 해 나간다.
はぁ……んっ……面白いわね、男の人って……朝から、こんな……ん、くぅんっ……	후~…… 읏…… 재미있네요, 남자는…… 아침부터, 이런…… 응, 쿠우읏……
起きたのね……んっ……ふふっ、起こしにきたら、ご主人様が大きく硬く、してたから……んっ……んっ……	일어났군요…… 읏…… 후훗, 일으키러 오면, 주인님이 크고 딱딱하고, 하고 있었기 때문에…… 읏…… 읏……
……その、はしたなかった、かしら……？　はぁ、はぁ、してあげたくなって……はぁ……	…… 그, 상스러웠다, 일까……? 하아, 하아, 해 주고 싶어져…… 하아……
んふぅ……んっ……はぁ……んっ、んんぅ……んっ……ふぅ……んっ、はぁ……んっ、んぅっ……んぅ……んっ……んんぅ……	…… 읏…… 하아…… 읏, 응응우…… 읏…… 후우…… 읏, 하아…… 읏, 응웃…… 응우…… 읏…… 응응우……
んっ、んっ、はぁ……んっ、んぁ……んぅっ、んっ……んんぅ、んんっ、あっ……はぁ……はぁ……んっ、んん……んぅっ、んっ……	응, 읏, 하아…… 읏, 응아…… 응웃, 읏…… 응응우, 응읏, 앗…… 하아…… 하아…… 읏, 응응…… 응웃, 읏……
ふああぁっ！！　こんなぁ……くぅ……	아!! 이런…… 쿠우……
……好きな人が、その……大きくしていたから。私がしてあげないとって、お、思ったの……	…… 좋아하는 사람이, 그…… 크게 하고 있었기 때문에. 내가 해 주지 않으면은, 오, 생각했어……
よく考えたら、凄まじい飛躍ね、恥ずかしい……	잘 생각하면, 굉장한 비약이군요, 부끄럽다……
すごく嬉しかったから、何の問題も無い……と思う。	굉장히 기뻤으니까, 어떤 문제도 없다…… 라고 생각한다.
……またしてくれると、嬉しいな。	…… 또 해 주면, 기쁜데.
……はい。ご主人様。	…… 네. 주인님.
くちゅくちゅ、と淫靡な音が響く。	질척질척, 라고 음미로운 소리가 울린다.
艶かしい、熱いくちゅくちゅとした感触。	요염한, 뜨거운 질척질척 한 감촉.
ん、ちゅっ……れるっ……はぁ、はぁ……おはよう……んちゅっ……ふふ、くわえちゃったぁ……んちゅっ……ちゅぷっ……	응, 츗…… 할짝…… 하아, 하아…… 안녕…… 응츗…… 후후, 입에 물어 버렸다아…… 응츗…… 츄풋……
んっ、ちゅっ、ちゅうっ……朝から、ご奉仕したいなって……んちゅっ……ちゅっ……大好き、らから……んちゅっ……	응, 츗, 츄웃…… 아침부터, 봉사하고 싶다는…… 츗…… 츗…… 너무 좋아, 들로부터…… 츗……
そのまま溶けてしまいそうな快楽を与えられ、俺は何も言えなくなる。	그대로 녹아 버릴 것 같은 쾌락이 주어져 나는 아무것도 말할 수 없게 된다.
私に、んちゅっ、全部任せて、んっ……ちゅっ……はぁ、はうっ……最後まで、わらひにさせてっ……んちゅううっ……	나에게, 응츗, 전부 맡겨, 읏…… 츗…… 하아, 하웃…… 끝까지, 짚히에 시켜…… 응츄우웃……
ちゅる……んっ……ちゅぱ……んはぁ……んっ、んぅ……んぢゅ……ちゅ……んんぅ……んっ……ちゅる……んふぁ……んっ、んっ……んちゅ……んっ……	…… 읏…… 츄파…… 응하아…… 읏, 응우…… 응쥬…… 츄…… 응응우…… 읏…… 츄루…… 응후아…… 읏, 읏…… 응츄…… 읏……
んっ、ちゅぱ……んんぅ、んんっ、んぢゅ……んっ、んっ、んぅ……ぢゅる、んっ、んんぅ……んふぅ……んっ、ぢゅぱ、んんっ……はぁ……んっ、んんぅ、ちゅぱ……	응, 츄파…… 응응우, 응읏, 응쥬…… 읏, 읏, 응우…… 쥬루, 읏, 응응우…… 응후우…… 읏, 쥬파, 응읏…… 하아…… 읏, 응응우, 츄파……
んっんっ……んぢゅっ、ぢゅ……ぢゅるる……んはぁ……んっ、んぅっ、んっ、んぢゅ、ぢゅる、ちゅぱ……んふぅ、んんっ、んっ、んむぅ……んっ、んぅっ、ぐちゅ、ちゅっ、ぢゅうぅ……	응응…… 응쥿, 쥬…… 쥬루루…… 응하아…… 읏, 응웃, 읏, 응쥬, 쥬루, 츄파…… 응후우, 응읏, 읏, 응므우…… 읏, 응웃, 구츄, 츗, 쥬우우……
んふぅぅっ！　んふ……んはぁ……んく……たくひゃん……ふぁ……	! 응후…… 응하아…… 응쿠…… 응…… 후아……
ふふ……こうしておけば、今日はもう他のメイドに浮気する事は無いかしらね……？	후후…… 이렇게 해 두면, 오늘은 이제 다른 메이드에게 바람피는 일은 없을까요……?
そんな目的があったの……？	그런 목적이 있었어……?
男の人って、一度出してしまえば、相当に気分は落ち着くと聞いたわ。だから……	남자는, 한 번 내 버리면, 상당히 기분은 침착한다고 (들)물었어요. 그러니까……
そうは言うが、俺のはまだ元気な状態を保っていた。	그렇게는 말하지만, 나의 것은 아직 건강한 상태를 유지하고 있었다.
も、もう……どうしてまだ、その……しょうがないご主人様ね。	도, 이제(벌써)…… 어째서 아직, 그…… 어쩔 수 없는 주인님이군요.
しょうがないご主人様だから……元気が無くなるまで、しないといけないわね……？	어쩔 수 없는 주인님이니까…… 건강이 없어질 때까지, 하지 않으면 안 되네요……?
どう、気分は？	어때, 기분은?
ふふ、なんだか頭がふわふわしてるわ……。はぅ、それにこれからご奉仕するって考えると、ドキドキするわね……	후후, 뭔가 머리가 어질어질해……. 거기다 지금부터 봉사한다고 생각하면 두근두근거려……
あぁ、俺もドキドキしてるよ。	아아, 나도 두근거려.
そう？　それは嬉しいわね。という事は、その……今日、たくさんするって事かしら。	그래? 그건 기쁘네. 그렇다는 건 그…… 오늘 많이 한다는 걸까.
当たり前じゃない、だってご主人様とするんだもの。……正直、今すぐにでもしたいくらい。	당연하잖아, 그거야 주인님이랑 하는 걸. …… 솔직히 당장이라도 하고 싶을 정도야.
大胆だね。……お酒のおかげかな。	대담하네. …… 술 때문일까.
それもあるけど、私……ご主人様とは、もっとしたいと思ってる、はぅん……	그것도 있지만, 나…… 주인님이랑 좀 더 하고 싶다고 생각해……
そうか。……それじゃ、今ここでしようか？	그런가 …… 그럼 지금 여기서 할까?
ご主人様ったら、いやらしいんだから……はぁ、あぅう……んぅっ……	주인님도 참 야하다니까…… 하아……
んん……！　ご、ご主人様、はぁはぁ、あぁん！　指、激しい……！　ひぅ！　あぁ……ひゃぁん！	…… 주, 주인님, 하아하아……! 손가락 격렬해……! 아아……!
この場所からでは、下手すれば誰かに聞こえてしまいかねないが……	여기서는 잘못하면 누군가에게 들려 버릴지도 몰라……
そ、そこいい、あぁん！　ご主人様、好き、大好きぃ……んん、はぅうう！　たくさん、私の中掻き回して……！	거, 거기 좋아, 아앙! 주인님, 좋아해, 너무 좋아해…… ! 잔뜩 내 안을 휘저어줘……!
あぅう、ご主人様ぁ！　はぁはぁ、わ、私の中、ぐちゅぐちゅって、いやらしい音してる……！　ご主人様の指、咥え込んでるから、はぅん！	……주인님! 하아하아, 내, 내 안이 찔꺽찔꺽 야한 소리를 내고 있어……! 주인님의 손가락을 물고 있으니까……!
だ、駄目、私ぃ、身体疼いてきてる……あぅう、ひゃぁん！　こんなところで、頭の中真っ白になりそう……！	아, 안돼, 나, 몸이 달아오르고 있어…… ! 이런데서 머리가 하얗게 될 것 같아……!
ぁああああっ！　わ、私ぃ、うぅ、もう我慢できないぃ！　はぁはぁ、イクイク、もうイクぅ、んんん～～～～～～っ！！	아아아앗! 나, 나…… 이제 못 참겠어! 하아하아, 가, 가, 이제 가버려……!!
肉襞は蠢き、愛液が滴り落ちていく。	질벽이 움찔거리며, 애액이 방울져서 떨어진다.
はぁ、はぁ、あぅう……。身体、まだ疼いてるぅ……頭、ふわふわして、んんぅ、ドキドキ治まらない……	하아, 하아……. 몸이 아직도 뜨거워…… 머리도 어질어질하고 두근거리는 게 멈춰지지 않아……
それなら、早く続きをしよう。	그럼 빨리 계속해서 하자.
そうね……。今度は指だけじゃなくても、他にもいろいろな事したいわ、はぁ、んぅっ……	그러네……. 이번엔 손가락 말고 다른 것도 이것저것 하고 싶어. 하아……
お酒が回っているせいだろう……普段よりもどこか無防備な雰囲気を纏っていた。	술기운이 돌고 있기 때문일 것이다…… 평소보다 어딘가 무방비한 분위기를 풍기고 있었다.
ふふ、ご主人様との夜伽、楽しみね……。私がたくさんご奉仕して、いっぱい気持ち良くするから。	후후, 주인님이랑 밤시중, 기다려지네……. 내가 많이 봉사해서 잔뜩 기분 좋게 해줄테니까.
本当？　それじゃ今日のご奉仕、楽しみにしてるね。	정말? 그럼 오늘의 봉사, 기대하고 있을게.
私はご主人様のメイドなんだから……ご主人様の為なら、どこでだって、なんだってするわ。	난 주인님의 메이드니까…… 주인님을 위해서라면 아무데서나 뭐든지 할게.
どこでも、なんでもって……本当？	아무데서나 뭐든지 한다니…… 진짜?
本当に決まっているじゃない。少しくらい酔っているからって、自分のメイドが信じられないの？	진짜인게 당연하잖아. 조금 취해 있다고 자기 메이드를 못 믿는 거야?
いやぁ、信じてるよ。それじゃ早速、有言実行してもらおうかな。	아니, 믿고 있어. 그럼 당장 그 말을 실행해볼까.
え、早速って……もしかして、この場でするって事？	에, 당장이라면…… 혹시, 여기서 한다는 거야?
ああ、そうだよ。お口でしてくれるかな……。もちろん、できるよね？	아아, 그래. 입으로 해줬으면……. 물론 할 수 있지?
はぅ、んちゅ……れるぅ、ぢゅ、じゅぶぅ……ご主人様の、熱くて……ちゅぷぅ、んぅ、美味しい、ちゅぷぅ……	…… 주인님의 거기, 뜨거워서……맛있어……
もっと、激しい方がいい？　じゅぷぅ、ぢゅるるぅ……んぷ、ご主人様、どう……？　れるぅ、ちゅ……んちゅぷぅ	좀 더 격렬한 편이 좋아? ……주인님, 어때……? …… 
んちゅ、わかった、じゅぷぅ、ぢゅ、んじゅぅうう……！　はぅ、んちゅ、じゅぶぶぅ、お口熱くなってくる、ちゅぱっ！	……알았어……! ……입안이 뜨거워져……!
ごひゅじんひゃまの、んぷぅ、どんどん硬くなってる、はぅ、じゅぶぶぅ！　わたしのくち、ぢゅるぅ、じゅ、きもひいい？	주이니메 거기…… 점점 딱딱해지고 있어……! 내 입…… 기분 좋아?
れるぅ、んじゅぷぅ！　　いいよ、ごひゅじんひゃま、ちゅぷぅ、わたしのくちで出して、じゅるるぅ！　あつくてこいの、ぜんぶ……！	…… 좋아, 주이니임…… 내 입에 싸줘……! 뜨겁고 진한 거 전부……!
にがいあじ、くちのなかでひろがってる、んぷぅ、じゅぶぅ！　がまんしないでいいから、ごひゅじんひゃま、れるれろぉ、んぢゅぅううう……！	씁쓸한 맛이 입안에 퍼지고 있어……! 참지 않아도 괜찮으니까, 주인님……!
ぢゅるるぅ、じゅぶぶぶぅ！　せいえきほしいの、ごひゅじんひゃまぁ！　れるぅ、じゅ！　んちゅぅ、じゅぶぶぶぶぶぅ！	…… 정액 갖고 싶어, 주인님!……
んぷ……！？　んんぅうううううううううっ！　はぅ、じゅぶぅ……口の中、いっぱい……はぁ、はぁっ……たくさん出たわね……	………… 입안에 잔뜩…… 하아…… 많이 나왔네……
こくこく、んくっ……ふふ、ご主人様の精液、美味しい……ちゅぷ、んく、こくっ……	…… 후후, 주인님의 정액 맛있어…… ……
ご主人様にそう言ってもらえるなんて、嬉しいわ……。ふふ、もっとしましょう、ご主人様。	주인님이 그렇게 말해 주니 기뻐……. 후후, 좀 더 하자, 주인님.
あぁ、もちろんだよ。	아아, 물론이야.
はぁ、んぅう……ふふ、ご主人様、今二人きりね……	하아…… 후후, 주인님, 지금 둘만 있네……
あぁ、そうだね……どうしたの、ずいぶんと機嫌が良さそうじゃないか。	아아, 그러네…… 왜 그래, 기분이 되게 좋아 보이는데.
だって、ご主人様と一緒だし、お酒も飲んでるし……機嫌が良くならないわけがないでしょう？	그게, 주인님이랑 같이 술도 마시고 있고…… 기분이 좋아지지 않을 이유가 없잖아?
はは、それは嬉しいな。	하하, 그건 기쁘네.
だから、ね。……ご主人様、ここでキスしていい？	그러니, 까…… 주인님, 여기서 키스 해도 돼?
はぅ、んちゅ、んん……ご主人様ぁ、ちゅ、ちゅぷぅ……好きぃ、んぅう、大好きぃ……	…… 주인님, 좋아…… 너무 좋아……
もう我慢できない、ちゅぱっ、ここでもう、ご奉仕したい……れろぉ、ちゅ、んちゅぷぅ……	이제 못 참겠어. 여기서 바로 봉사하고 싶어…………
はぅ、じゅぷぅ……ちゅるぅ……本気よ、ご主人様ぁ……んちゅ、頭ふわふわして、すごく良い気分なの……	…… …… 진심이야, 주인님…… 머리가 어질어질해, 엄청 좋은 기분이야……
だってご主人様といたら、身体が疼いてきたから……。それよりも、ご主人様……早く挿れてほしい……	그게 주인님이랑 있으면 몸이 달아오르니까……. 그보다도, 주인님…… 빨리 넣어줬으면 좋겠어……
はぁ、んくぅん……！　奥まで太いのが、あっ、あっ……届いてる、んん、これが欲しかったの、はぅん……	하아……! 안쪽까지 굵은 것이…… 닿고 있어…… 이걸 갖고 싶었어……
カリが引っ掛かって、あぁ、んく……そこ、はぅ……先っぽが奥に当たって、あぅう、声抑えられない……！	귀두가 들어와서, 아아…… 거기…… 끝이 안쪽에 닿아서…… 소리를 못 참겠어……!
だって、ご主人様の気持ち良いからぁ、はぅん……私、頭の中ふわふわして、んくぅ、もっと激しくして、ご主人様ぁ……	그치만 주인님의 거기 기분 좋으니까…… 나 머릿속이 어질어질해…… 좀 더 격렬하게 해줘, 주인님……
そうか。それなら遠慮なく……	그런가. 그럼 사양하지 않고……
んんん～～～っ！　はぁはぁ、あぅ、ご主人様で、中がいっぱい、んく、ぁああああっ！	……하아하아, 주인님으로 안이 가득……!
んぅ、いやらしい音鳴ってる、はぅう、ご主人様にぜんぶ聞かれてる、あぁ、はぅうん！	야한 소리가 나오고 있어…… 주인님에게 전부 들리고 있어……!
き、気持ち良い、はぅ、わたし、ご主人様の事大好きで……あっ、んぅうう！　ご奉仕できるのが、嬉しいの……！	기, 기분 좋아, 나, 주인님을 정말 좋아해…… ! 봉사할 수 있다는 게 기뻐……!
もちろんよ、ご主人様ぁ、んくぅん！　はぁ、あぁん！　もっとたくさん、ご主人様を感じさせて……！	물론이야, 주인님…… 좀 더 잔뜩 주인님을 느끼게 해줘……!
んん、はぅう、ご主人様の熱くて、はぁはぁ、私の身体、疼いてくる……！　こ、こんなにされたら私、私ぃ、んひぃん！	……주인님의 것 뜨거워서, 하아하아, 내 몸이 달아 올라……! 이, 이렇게 되면 나, 나……!
あぅう、ご主人様ぁ！　そ、そんな事言われたら、抑えられなくなるぅ、んく、ひゃぁん！　私の中、もうぐちゅぐちゅで、はぅううう……！	……주인님! 그, 그런 걸 말하면, 참을 수 없어……! 내 안, 벌써 질척질척해……!
あっ、あっ、もう駄目ぇ！　奥まで熱くて、このまま蕩けるっ、んぅ、はぅうん！　好き、大好き、ご主人様ぁ！　ぁあああああっ……！	……이제 안돼! 안쪽까지 뜨거워져서 이대로 녹겠어……! 좋아해, 너무 좋아해, 주인님! 아아아앗……!
んひぃぃぃぃぃぃぃん！　はぅう、あぅううううん……！	…………!
膣内が収縮して、肉襞が精液を絞り出すかのようにペニスを刺激する。	질 내가 수축하고 질벽이 정액을 짜내려는 듯이 페니스를 자극한다.
はぅうううう……！　んくぅ、うぅう、す、すごい、ご主人様の精液が、奥にぃ……私の奥に、注ぎ込まれて、はぅ、熱いぃ……	…… 대, 대단해, 주인님의 정액이, 안쪽에…… 내 안쪽에 쏟아져서…… 뜨거워……
精液、こんなに……。嬉しいわ、ご主人様……んぅ、私の中で、こんなに感じてくれるなんて……	정액, 이렇게나……. 기뻐, 주인님…… 내 안에서 이렇게 느껴 주다니……
あぁ、ご主人様ぁ……精液勿体ない、はぅう……せっかく熱くて濃いの、こんなに出してくれたのに、零れて……	아아, 주인님…… 정액 아까워…… 모처럼 뜨겁고 진한 걸 이렇게 싸줬는데 흘러넘쳐……
大丈夫だよ、また出してあげるから。……それに、夜伽はまだまだこれからだろ？	괜찮아, 또 싸줄테니까. …… 그리고 밤시중은 아직 지금부터인데?
……そうね。わかったわ、ご主人様……んぅ、場所を変えて、続きをしましょう……？	…… 그러네, 알았어. 주인님……  장소를 바꿔서 계속 하자……?
ごめん、ご主人様……。んぅ……私、もう我慢できない、はぁ、はぁ……	미안, 주인님……. …… 나 이제 참을 수 없어, 하아, 하아……
我慢できないって、何が？	참을 수 없다니, 뭐가?
なんだかふわふわして、はぅう……いやらしい事で頭がいっぱいになってるから……	뭔가 어질어질 해…… 야한 일로 머리가 가득 차서……
ふぅん、そうなんだ。……それなら、自分ですればいいじゃないかな？	흠, 그렇구나…… 그럼 스스로 하면 되잖아?
じ、自分で……？　ご主人様は、その……してくれない……？　あぁ、はぅう……	스, 스스로……? 주인님이 그…… 해 주지 않을래……? ……
んぅ、それなら一人でする……はぁ、うぅ、このまま何もしないなんて、耐えられないから、はぁ、あぅうん……	……그럼 혼자서 할래…… 하아, 이대로 아무것도 안하면, 못 참겠으니까, 하아……
はぁ、あぅん……んん、身体がなんだか火照ってる……うぅ、ご主人様と一緒にいるだけで、ドキドキしてしまって……	하아…… 몸이 뭔가 달아오르고 있어…… 주인님이랑 함께 있는 것만으로도 두근거려……
ご主人様の前で、私ぃ、んぅう……自分の中弄って、はぁ、はぅう……こんないやらしい事してるなんて……ご主人様、嫌いにならないでね……	주인님의 앞에서 나…… 스스로 만지작거리고…… 이런 야한 짓을 하고 있어…… 주인님, 싫어하지 말아줘……
嫌いになったりしないけど……もしかして、俺の事を考えてオナニーしてる？	싫어하지는 않지만…… 혹시 날 생각하면서 자위하고 있어?
そ、それは、はぅん……だって、目の前にご主人様いるのに、触ってくれないから、自分でくちゅくちゅってして、んん……	그, 그건…… 그치만 눈앞에 주인님이 있는데 만져 주지 않으니까, 스스로 찔꺽찔꺽……
言わないでほしい、そんな事、はぁ、んぅう！　もうぐちゅぐちゅってして、あぅ、敏感なところ、硬くなってる……！	말하지 말아줘, 그런 거……! 벌써 질척질척해…… 민감한 곳이 딱딱해지고 있어……!
そしてそのまま、熱く充血しているクリトリスを指で弄り始めた。	그리고 그대로, 뜨겁게 충혈되어 있는 클리토리스를 손가락으로 만지작거리기 시작했다.
んひぃいん！？　あぁ、はぁはぁ、身体疼く、んん！　ご主人様の前で、もう止まらないぃ……！　熱くて、私ぃ、ぁあああっ！	……아아, 하아하아, 몸이 달아올라……! 주인님의 앞에서, 이제 멈출 수 없어……! 뜨거워서, 나……!
ずいぶんな乱れようだね。もうイキそうなの？	꽤나 흐트러지네. 이제 갈 것 같아?
え、ええ、もうイキそう、あぁ、んひぃん！　オナニー気持ち良くて、私駄目になりそう！　ひぅう！　はぁはぁ、んはぁあん！	으, 응, 이제 갈 것 같아……! 자위 기분 좋아서, 나 안될 것 같아! 하아하아……!
ご、ご主人様、あぅう、私がイクところ、見ていて！　ぁああっ、んぅ！　はぁん！　も、もう、イクぅ、ひやぁぁぁぁぁぁぁん！！	주, 주인님…… 내가 가는 걸 보고 있어! ……이, 이제 가버려……!!
はぁっ！　ん、くっ……んんんんんん～～～～～～～～！！	하앗! ……!!
その指先は自らの雫で濡れそぼり、卑猥な色気を湛えていた。	그 손가락 끝은 자신의 물방울로 흠뻑 젖어, 음란하게 반짝거리고 있었다.
はぁあ、んん～～～っ……あぁ、んぅう……ぐちゅぐちゅってしながら、私……。あぁ、こんなところで、オナニーでイクなんて……	하아…… 아아…… 질척질척 하면서 나……. 아아, 이런데서 자위로 가버리다니……
どう、気持ち良かった？	어때, 기분 좋았어?
すごく、んぅ……気持ち良かったわ……。だけど……	엄청…… 기분 좋았어……. 그런데……
だけど？	그런데?
自分でするだけじゃ、物足りない……。オナニーだけじゃ満足できないから、はぅうう……ご主人様としたい……	스스로 하는 걸로는 부족해……. 자위만으로는 만족 못하니까…… 주인님으로 하고 싶어……
すでに気持ちは、これからの夜伽でいっぱいになっているのだった。	이미 마음은 앞으로의 밤시중으로 가득 차있는 것이었다.
はぅう、ご主人様ぁ……。ちょっと、その……待ってもらっていいかしら？　はぁ、んぅっ……	주인님……. 잠깐, 그…… 기다려줄수 있을까? ……
傍目にもふらふらしているのがわかる。	옆에서 보기에도 휘청거리고 있는 것을 알 수 있다.
え、ええ、そうね……。はぅ、そのせいで、私ぃ……むずむずしてるから……	으, 응, 그러네……. 그래서 나…… 근질근질거려……
むずむずしてるっていうのは？	근질근질하고 있다는 건?
その、トイレに行きたい……。もう我慢できなくなりそうで、はぅう……このままだと、ここで漏れる……	그, 화장실 가고 싶어……. 이제 못 참겠어…… 이대로면 여기서 흘러나와……
ふぅん。漏らしちゃえば？	흐음. 나오게 하면 되잖아?
……え？　も、漏らすって……おしっこ、ここでって事……？　うぅ、ご主人様、何を言ってるの……	…… 응? 나, 나오게 하라니…… 오줌을 여기서……? 주인님, 무슨 말을 하는 거야……
ド、ドキドキなんて、してない……。んぅ……でもご主人様は、自分のメイドがこんなところで粗相をしていいの……？	두, 두근거리고 있지 않아……. …… 그치만 주인님은 자기 메이드가 이런데서 실수해도 괜찮은 거야……?
はぁ、はぅう……わ、私は、私は……その……	하아…… 나, 나는, 나는…… 그……
……大丈夫だよ。俺以外に、誰も見てる人なんかいないからさ。	…… 괜찮아. 나 말고는 아무도 보는 사람 없으니까.
わ、わかったわ……。私も、もう限界だったから、はぁ、んぅっ……	아, 알았어……. 나도 이제 한계니까, 하아……
私、こんなところでおしっこしようとしてるなんて……はぁ、あぅう、まるで変態みたい……	나, 이런데서 오줌누려고 하다니…… 마치 변태같아……
……ご主人様、意地悪言わないでほしい……。あぅ、も、もう出る、我慢できないぃ……	…… 주인님, 짓궂게 말하지 말아줘……. 이, 이제 나오는 거 못 참겠어……
はぁ、あぅう、だ、誰が来るかもしれないような場所で、ご主人様の前で……漏れる、おしっこ漏れる……っ！　ぁああああっ……！	하아…… 누, 누가 올지도 모르는 곳에서, 주인님의 앞에서…… 나와, 오줌 나와……!
尿が地面に雫を放ち、水溜りができていく。	지면에 오줌 물방울을 날려서 웅덩이가 생기고 있다.
どう、おしっこ漏らした気分は？	어때, 오줌 싼 기분은?
はぁ、はぁ……い、いけない事なのに、気持ち良くて、私ぃ……。駄目、ここお掃除しないと……	하아, 하아…… 아, 안되는데, 기분 좋아서 나……. 안돼, 여기 청소하지 않으면……
掃除なんて別にいいよ。このままにしておこう。	청소 같은 거 딱히 안해도 돼. 이대로 해 두자.
で、でもそれじゃ、うぅ……私のおしっこ、誰かに見られてしまうじゃない……	그, 그치만 그럼…… 내 오줌 누군가 봐 버리잖아……
それは、そうだけど……でも、その……いいの？	그건 그렇지만…… 그래도 그…… 괜찮아?
んっ、わかったわ……。私もそうだけど、ご主人様だって変態よ。それじゃ、続きは場所を変えてから……しましょう？	응, 알았어……. 나도 그렇지만 주인님도 변태야. 그럼 다음은 장소를 바꾸고 나서…… 하자?
……ご主人様、その……私、もう抑えられない……	…… 주인님, 그…… 나 이제 못 참겠어……
さっきからそわそわしている様子だったし、まさかとは思っていたけど……	아까부터 안절부절 못하는 것 같던데, 설마라고는 생각하지만……
そんな事言わないでほしい……。ご主人様が目の前にいるのに、我慢なんてできるわけないじゃない……	그런 말은 안했으면 좋겠어……. 주인님이 눈앞에 있는데 참을 수 있을리가 없잖아……
そうか。……じゃあ、ちゃんとおねだりできる？	그런가. …… 그럼 제대로 졸라댈 수 있겠어?
お、おねだり……？　ご主人様、おねだりすれば、ここでキスさせてくれる……？	조, 조르라고……? 주인님, 졸라대면 여기서 키스해 주는 거야……?
言えるわ、ご主人様……。んんぅ、キスさせて、お願い……！　私は、待ちきれなくてキスしたくなってるいやらしいメイドだけど……	말할게, 주인님……. 키스해줘, 부탁해……! 난 참지 못하고 키스 하고 싶어하는 음란한 메이드니까……
ご主人様の事、大好きだから……せめて、キスだけでもさせて、ご主人様……	주인님을 정말 좋아하니까…… 적어도 키스라도 해줘, 주인님……
はい、よくできました。	네, 잘 말했습니다.
はぅ、んちゅ……ちゅぷぅ……好き、好きぃ、ご主人様……はぁ、んぢゅぅ……！	………… 좋아해, 좋아해, 주인님…… 하아……!
だってご主人様の、大好きだから……んぷ、ぢゅっ……ご主人様は、私の事好き……？　ちゅるぅ……じゅ、ぢゅぷぅ……	그거야 주인님을 정말 좋아하니까…… …… 주인님은 날 좋아해……?  ……
わかった、ちゅっ、んちゅぷぅ……私のキス、たくさん味わって、ちゅぷぅ……はぅ、ちゅぱっ……	알았어…… 내 키스, 잔뜩 맛 봐 …… ……
俺の唇にその先端が触れて、口内へと侵入してくる。	나의 입술에 그 끝이 닿아서, 입안으로 들어온다.
んぢゅぅ、じゅっ……れるぅ、んぷぅ……どう、ご主人様……？　ちゅるるぅ、んん、じゅぶぅ……！	…… …… 어때, 주인님……? ……!
ぢゅぷ、嬉しい、ご主人様……。私、ご主人様にもっとご奉仕がしたい、ご主人様に気持ち良くなってほしい、れるぅ、んちゅぷぅ……！	……기뻐, 주인님……. 나 주인님에게 좀 더 봉사하고 싶어. 주인님을 기분 좋게 해주고 싶어……!
それなら、早く場所を変えよう……。ここじゃ、続きがやりにくい。	그럼 빨리 장소를 바꾸자……. 여기서는 이 다음을 하기 힘들어.
私は別に、んちゅぅ……ここでしても、構わない、れろぉ、じゅっ……ちゅぷ、んぷぅ……	나는 딱히…… 여기서 해도 상관 없어…… ……
そう、わかったわ……じゅぷぅ、ちゅぅ……でも、もう少しだけキスさせて、んちゅ、好き、好きなの、ご主人様、大好きぃ……	그래, 알았어…… … 그치만 조금만 더 키스 해줘…… 좋아해, 좋아해, 주인님, 너무 좋아해……
ご、ご主人様……。その、ちょっといいかしら。	주, 주인님……. 그, 잠깐 괜찮을까.
そうじゃないの、体調は問題ないわ。……そうじゃなくて、ご主人様、ちょっと動かないで。	그런 건 아냐, 컨디션은 문제 없어. …… 그게 아니라 주인님, 잠깐 움직이지 마.
その、口でしたいの……私、抑えられなくて……。ご奉仕させて……	그, 입으로 하고 싶어…… 나 못 참겠어……. 봉사하게 해줘……
はぅ、んちゅ……これが欲しかった、じゅぶぅ……ご主人様の大きいの、私の口で、れろぉ、ちゅ、じゅぷぅ……	…… 이걸 갖고 싶었어…… 주인님의 커다란 걸 내 입으로 ……
それが逆に欲情を誘う……卑猥な口使いで、俺のモノを責め立てていく。	그것이 반대로 욕정을 부르고…… 음란한 입 사용으로, 나의 것을 몰아세운다.
だって私、れろぉ、じゅるぅ……ご主人様の事、大好きだから、ちゅぱっ……早くご奉仕したくて、んぷ、ちゅぅ……じゅぶぶぅ……	왜냐면 나…… 주인님을 정말 좋아하니까…… 빨리 봉사하고 싶어서…………
ちゅるるぅ、んぅ……これでも私、我慢していたのよ、ちゅぷぅ……でも、ご主人様を前にしたら、はぅ、抑えきれなくて、んちゅぷ……	…… 이래보여도 나 참고 있었던 거야…… 그치만 주인님을 앞에 두면 참을 수가 없어서……
そうなんだ……。そこまで想われてるなんて、ご主人様冥利に尽きるな。	그렇구나……. 그렇게까지 생각해주다니, 주인님에겐 과분하네.
んちゅ、ちゅぅ……！　んぷ、苦いのが出てる……ご主人様、ちゅるぅ、気持ち良い……？　私の口、れろぉ、じゅるるぅ……	……씁쓸한 게 나오고 있어…… 주인님……기분 좋아……? 내 입……
あぁ、気持ち良いよ……	아, 기분 좋아……
ふふ、良かった、じゅぷぅ……私のお口、もっと味わって……たくさんするから、はぅ、んちゅ、じゅぶぶぅ……	후후, 다행이야, …… 내 입, 좀 더 즐겨…… 많이 해줄테니까……
れるぅ、んぢゅ、じゅぶぶ、ごひゅじんひゃま、んぐちゅぅ、いつでもだして、わたしのくちにぃ、れるれろぉ、んちゅぷぅ……！	……주인님…… 언제든지 싸줘…… 내 입에……!
あつくてこいせいえき、じゅぶぅ、たくさんほしい、ちゅる、ぢゅるるぅ！　ごひゅじんひゃまの、ぜんぶぅ！	뜨겁고 진한 정액…… 잔뜩 갖고 싶어……! 주이니메 전부!
あまりに激しい奉仕に、怒張した俺のペニスがビクビクと脈打ち始める。	너무나도 격렬한 봉사에, 부풀어 오른 나의 페니스가 움찔움찔 맥박치기 시작한다.
んじゅぅ、イキそう、ごひゅじんひゃま？　れろぉ、じゅっ、じゅぶぶぅ！　えんりょしないでいいから、すきなときにイって、ちゅるぅ、んじゅぷぅ！	……갈 것 같아, 주인님? ……참지말고 마음대로 가도 돼……!
うぅ、んぷぅ……！？　んん、ちゅるぅ、じゅぷ……あついのが、たくさんでてる、はぅん……すごい、こんなに……	………… 뜨거운 게 잔뜩 나와…… 대단해, 이렇게나……
こくこく、んぅ……んく、精液どろどろで、はぅう……駄目、零したらもったいない……こくっ……	…… 정액이 질척질척해…… 안돼, 흘리면 아까워…………
精液を嚥下して喉を鳴らすその姿は、とても卑猥だった。	목에서 정액을 삼키는 소리를 내는 그 모습은 매우 음란했다.
ちゅぷ……気持ち良かった、ご主人様？　私の口……	…… 기분 좋았어, 주인님? 내 입……
あぁ、すごく良かったよ。	아아, 엄청 좋았어.
ふふ、嬉しい……。ご主人様の精液も、とても美味しかったわ。今、お腹の中熱くなってる……	후후, 기뻐……. 주인님의 정액도 엄청 맛있었어. 지금 뱃속이 뜨거워지고 있어……
そんな風に言われたら……早く続きがしたくなるな。	그런 식으로 말하면…… 빨리 그 다음을 하고 싶어지네.
嬉しいわ、ご主人様。……それじゃ、早く移動しましょう。そうしたら、たくさんご奉仕するわ。	기뻐, 주인님. …… 그럼 빨리 이동하자. 그러면 잔뜩 봉사할게.
先ほどまで俺のペニスを咥えていた唇で笑顔を見せる。	방금 전까지 나의 페니스를 물고 있던 입술로 웃는다.
その想像に、思わず我慢できなくなりそうだったので、急いで場所を移す事にしたのだった。	그렇게 상상하자 참지 못할 것 같아서, 서둘러 장소를 옮기기로 한 것이었다.
私、我慢できない……。いやらしいって思われてもいい……ご主人様、お願いがあるの。	나 못 참겠어……. 음란하다고 생각해도 좋아…… 주인님, 부탁이 있어.
今ここで……キスしていい？　ご主人様に……	지금 여기서…… 키스 해도 돼? 주인님에게……
あぁ、構わないけど。	아아, 상관없는데.
はぅ、んちゅぷぅ……好き、ご主人様ぁ……ちゅるぅ、もっと早くこうしたかった、ちゅっ、たくさんたくさん、ご主人様と、んん……！	…… 좋아해, 주인님…… 좀 더 빨리 이렇게 하고 싶었어…… 많이, 많이, 주인님이랑……!
潤んだその瞳には、俺が映っていた。	촉촉한 그 눈동자에 내가 비치고 있었다.
うぅ、キスだけじゃ物足りない……。もっとご主人様が欲しい……深いところまで、ご主人様が……	……키스만으로는 부족해……. 좀 더 주인님을 원해…… 깊은 곳까지 주인님이……
それってどういう事？　はっきり言ってくれないと、きちんと伝わらないな。	그건 무슨 말이야? 확실히 말하지 않으면 제대로 모르겠네.
ご主人様のが欲しいのよ……私の中に、ご主人様の大きいの感じたい……。今この場所で、セックスがしたいの……！	주인님의 거기를 갖고 싶어…… 내 안으로 주인님의 커다란 걸 느끼고 싶어……. 지금 여기서 섹스하고 싶어……!
はぁあ、あぁ……ご主人様、んくぅ……これ、これが欲しかった……んん、うぅ……ご主人様、好きぃ……！	하아, 아아…… 주인님…… 이걸, 이걸 갖고 싶었어…… …… 주인님 좋아……!
お、奥まで太いのが届いて、ぁああっ、んん……もっと速くしても大丈夫だから、ご主人様……はぁはぁ、あぅうん……	아, 안쪽까지 굵은 것이 닿고 있어…… 좀 더 빠르게 해도 괜찮으니까, 주인님…… ……
はぅうう！？　あぁ、んくぅ、ご主人様ぁ！　太いの擦れてる、うぅ、私の中ぁ……はぅう、んん！	……주인님! 굵은 걸로 쑤셔지고 있어……내 안…… !
き、気持ち良い、はぅう、ご主人様の事、大好きだから私ぃ、んん！　はぁはぁ、もっとたくさん、ご主人様を感じたい、あぁ、んくぅん！	기, 기분 좋아……주인님을 정말 좋아하니까, 나……! ……좀 더 잔뜩 주인님을 느끼고 싶어……!
駄目、私もう我慢できなくなりそう……！　あぅう、ひぃいん！　はぁ、んく、頭の中真っ白になる、気持ち良過ぎて、抑えられない……！	안돼, 나 이제 못 참겠어……! ……머릿속 하얘져, 기분 너무 좋아, 못 참겠어……!
そもそもこの場所でここまでする気もなかったけど……俺は勢いに任せて、激しく奥まで掻き回す。	원래 여기서 이렇게까지 할 생각은 없었지만…… 나는 기세를 타고 격렬하게 안쪽까지 휘젓는다.
んぅう、ぁあああっ！　いやらしい声、抑えられないぃ、んんぅ、ご主人様、好きぃ、大好きぃ！　うぅ、気持ち良過ぎて、蕩けそう……！	……야한 목소리, 못 참겠어…… 주인님, 좋아, 너무 좋아! ……기분 너무 좋아, 녹을 것 같아……!
あぁ、んくぅ！　ご、ご主人様ぁ！　中ヒクヒクして、私ぃ！　イク、もうイクぅ、ご主人様、はぅうう、ぁああああああっ……！	……주, 주인님! 안이 움찔움찔해, 나 가! 가버려, 이제 가버려, 주인님, 아아아아아아앗……!
んんん～～～～っ……！　あぁ、ご主人様のがたくさん……んぅ、中どろどろになってる、あぁ、はぅん……	…… 아아, 주인님의 것이 잔뜩…… 안이 질척질척거리고 있어……
はぁ、んぅ……ええ、私は大丈夫よ、ご主人様……熱くて濃いの、いっぱい出してくれて嬉しい、あぅん……	하아…… 응, 나는 괜찮아, 주인님…… 뜨겁고 진한 걸 잔뜩 싸줘서 기뻐……
うぅ、もう待ちきれない……ご主人様……私、お願いがあるの……	……이제 더는 못 기다리겠어…… 주인님…… 나, 부탁이 있어……
お願い？　これから夜伽をするのに、一体なに？	부탁? 지금부터 밤시중을 할 건데 도대체 뭐야?
私の事、苛めてほしい……。ご主人様ので、たくさん……	날 괴롭혀주면 좋겠어……. 주인님의 거기로 잔뜩……
苛めてほしい？　……どうして、それをこの場で言うの？	괴롭혀 달라고? …… 왜 그걸 여기서 말하는 거야?
俺の股間を前にして座り、苛めてほしいという……それはつまり……	나의 사타구니를 앞에 두고 앉아서 괴롭혀주면 좋겠다…… 그것은 즉……
ご主人様の、逞しいモノで……私の口に、お仕置きしてほしくて……。お願い、ご主人様……	주인님의 씩씩한 물건으로…… 내 입에 벌을 줬으면 해서……. 부탁해, 주인님……
わざと焦らすように、俺は意地悪な質問をした。	일부러 애가 타도록, 나는 심술궂은 질문을 했다.
それは……だって私、こんな場所で欲しがるような、へ、変態だから……ちゃんとご主人様に躾けてもらわないと……	그건…… 왜냐면 난 이런데서 하고 싶어 하는 벼, 변태니까…… 제대로 주인님이 길들여주지 않으면……
……そうか。それなら仕方ないな。	…… 그런가. 그럼 어쩔 수 없네.
んぷ、うぅ……！　はぐぅ、ごひゅじんひゃまの、おっきい、んん、うくぅ……あぅ、のどおくまで、とどいてる……ぁああっ、んぐぷぅ……	…… 주이니메꺼 커다래……  목 안쪽까지 닿고 있어…… ……
んぐぅ！？　うぅ、んぷぅ、うぐ！　は、はげひい、んん、んぐぷぅ、ごひゅじんひゃまに、たくさんおしおきれてぇ、うう、はぐぅう……！	……겨, 격렬해!…… 주이니메게 잔뜩 쑤셔져서……
くちのなか、んぅ、ごひゅじんひゃまのでみたされて、はぐぅ、んぷ、あたまぼうっとうする……あぐぅ！　んぷ、ぉおご、んん～～っ……！	입 안이 주이니메 거스로 가득차서……머리가 멍해져……!
はぅ……そ、そんらことない、んぐ、んんぅ……ちゃんとわたしぃ、メイドとしてしつけられてる……うぐ、はぅうう……	…… 그, 그렇지 않아……제대로 나, 메이드로서 가르침 받고 있어…… ……
本当か？　それじゃ、確認する為にもっと激しくしないとな。	정말? 그럼 확인하기 위해서 좀 더 격렬하게 하지 않으면 안되겠네.
んん！？　んん～～～～っ！　んぐぷぅ、はぐ、うぇええ！　あぐぅ、ごひゅじんひゃまぁ、んぅうん、うぅ、わたし、わたしぃ！	……저, 주인님! 나, 나……
んぐ、ひぐぅう、おしおきされて、ドキドキしてる、はぅ、んんん～～っ！　いじめられて、こうふんしてる、へんたいメイドになってる、んぐぷぅ！！	……벌 받으면서 두근거리고 있어……! 괴롭혀져서 흥분하고 있어, 변태 메이드가 됐어……!!
ああ、その通りだな……！　ほら、仕上げだ、この変態メイド。その口の中にだしてやるから、きちんと飲み込め。	아아, 그 말 대로다……! 자, 마무리다, 이 변태 메이드. 그 입안에 싸줄테니까 제대로 삼켜라.
はぐ、んぷ、わ、わかった、んぐ、うぇえ、ひゅぐ、んぅううう！？　だ、だめ、もうなにもかんがえられなくなりそう、んん、んぐぷぅ！	……아, 알았어……!? 아, 안돼, 이제 아무 생각도 못하겠어……!
ご、ごひゅじんひゃまぁ、んぷぅ、んんん～～～っ！　はぐぅう、あ、あついぃ、んぐぷぅ……すごい、あついのがたくさんでてるぅ、うぇええ……！	주, 주인님……! 뜨, 뜨거워…… 대단해, 뜨거운 게 잔뜩 나왔어……!
んぐ、ごほごほっ……はぅ、けほ、うぅ……く、口の中、どろどろ……それに、こほっ……ご主人様の匂いで、頭がくらくらする……	 …… …… 이, 입 안이 질척질척해…… 그리고…… 주인님의 냄새로 머리가 어질어질해……
はぅ……あぁ、ご主人様ぁ……熱くて濃いのが、わたしの……んん、口の中にたくさん……んちゅ、はぅうん……	하아…… 아아, 주인님…… 뜨겁고 진한 게 내……  입 안에 잔뜩…… ……
言われなくてもわかっているだろうけど……せっかく出したんだ。全部飲み込むんだぞ。	말하지 않아도 알고 있겠지만…… 모처럼 싼 것이다. 전부 삼켜라.
ええ、もちろんよ……んぅ、こくこく……熱いのが、お腹の中まで、んく……こくっ、私、蕩けてしまいそう……	응, 물론…… …… 뜨거운 게 뱃속까지…… 나, 녹아 버릴 것 같아……
んちゅぅ、ありがとう、ご主人様……私みたいな変態メイドに、精液をたくさん注ぎ込んでくれて、あぁ、はぅう……	고마워, 주인님…… 나같은 변태 메이드에게 정액을 잔뜩 싸줘서……
ああ。……だけど、まだ終わりじゃないぞ。これからが本番だからな。	아아. …… 하지만 아직 끝이 아니다. 지금부터가 본방이니까.
わかってるわ、んぅ……私、もっともっと、ご主人様にご奉仕したい、あぁ、ちゅるぅ……	알고 있어…… 나 좀 더 좀 더 주인님에게 봉사하고 싶어……
それから、これからする夜伽に胸を高鳴らせるのだった。	그리고 지금부터 할 밤시중에 가슴이 쿵쾅대는 것이었다.
ねえ、ご主人様……。私、お願いしたい事があるのだけど……	저기, 주인님……. 나, 부탁하고 싶은 게 있는데……
お願いね……。それは、どんなお願いなのかな？	부탁이라……. 그건 어떤 부탁이려나?
今ここで、ご主人様が欲しい……。我慢できないの、ご主人様……！	지금 여기서 주인님을 원해……. 못 참겠어, 주인님……!
そ、そんな、ご主人様……意地悪言わないでほしい、ご主人様……。奥まで、太いの捻じ込んで……	그, 그런, 주인님…… 짓궂게 말하지 말아줘, 주인님……. 안쪽까지 굵은 걸로 쑤셔넣어……
んんん～～～～っ……！　あぐぅ、んく……ご主人様のが、私の中にぃ、んん、はぁはぁ、ぁあああっ！	………… 주인님의 거기가 내 안에……!
ま、まだ挿れたばかりなのに、はぐぅ……いやらしい声出る、んん、あぅう、ご主人様の感じるの、好きぃ……！	아, 아직 넣기만 했을뿐인데…… 야한 소리가 나와…… 주인님이 느껴져서 좋아……!
俺が動く度に、離したくないとばかりにペニスを締め付ける。	내가 움직일 때마다 떨어지고 싶지 않다는 듯이 페니스를 단단히 조인다.
そのまま、俺は抽送速度を速める事にした。	그대로 나는 삽입 속도를 높이기로 했다.
はぐぅ、やぁん！　は、激しい、もっと苛めてほしい、ご主人様、はぁはぁ、んんぅ！　太くて硬いので、たくさん……！	……겨, 격렬해, 좀 더 괴롭혀줘, 주인님, 하아하아……! 굵고 딱딱해서 잔뜩……!
ひゃぁん！　あぅ、ご主人様ぁ……！　お尻叩かれると、んく、我慢できない、はぁはぁ、小さな子供みたいにされて、んん～～～っ！	……주인님……! 엉덩이를 맞으면…… 못 참겠어, 하아하아, 어린애 같아……!
はぁ、んくぅん！　ご、ご主人様、はぁはぁ、お尻じんじんしてる、ぁああっ、はぅううう……！　苛められて、私ぃ！	하아……! 주, 주인님, 하아하아, 엉덩이 찌릿찌릿해……! 괴롭혀지고 있어, 나!
もっとしてほしい、中もお尻も、はぅう、んひぃいん！　お仕置きされるの、好きぃ、んんっ、ぁああっ、ご主人様ぁ！	좀 더 해줬으면 좋겠어, 안에도 엉덩이도……! 벌 받는 게 좋아…… 주인님!
わ、私、はぁはぁ、ご主人様に苛められるの好き、お尻叩かれるの好きぃ……！　んん、ぁあああっ！　もう身体熱くなってる……！	나, 나, 하아하아, 주인님에게 괴롭혀지는 걸 좋아해, 엉덩이 맞는 게 좋아……! 이제 몸이 뜨거워져……!
そうか、それならこのまま中に出すぞ。ちゃんと受け止めろよ。	그런가, 그럼 이대로 안에 싼다. 제대로 받아 들여라.
わかった、んくぅ、ひぃん！　中疼いて、私も蕩けそう……い、今出されたら、はぅう、苛められて頭真っ白になる、んぅううう！	알았어……! 안쪽이 달아올라서 나도 녹을 것 같아…… 지, 지금 나오면…… 괴롭혀져서 머리가 하얗게 돼……!
肉襞が擦れて、先端が膣の最奥に触れた瞬間、俺のペニスは限界を迎えた。	질벽을 지나서 끝부분이 질의 가장 안족에 닿은 순간, 나의 페니스는 한계를 맞이했다.
んんん～～～～～っ！？　ぁあああっ、ご、ご主人様ぁ、ひぐぅう、ぁあああああっ！	……주, 주인님……아아아아아앗!
肉襞が蠢いて、精液を絞り出していく。	질벽이 꿈틀거리며 정액을 짜내기 시작한다.
はぁ、あぅうう……！　まだ、身体疼いて……んんぅ、熱いの、たくさん出してくれて嬉しい、ご主人様……	하아……! 아직도 몸이 달아올라…… 뜨거운 걸 잔뜩 싸줘서 기뻐, 주인님……
あぁ、はぅん……も、もう抜くの……？　私、もっとご主人様とつながっていたいのに……	아아…… 버, 벌써 빼는 거야……? 나, 좀 더 주인님이랑 연결되어 있고 싶은데……
ああ、だけど続きはここじゃなくて場所を変えてからだよ。	아아, 그치만 다음은 여기가 아니고 장소를 바꾸고 나서야.
んぅ、わかった……あぅう……ご主人様のが零れる、んん、もったいない、せっかくのご主人様の精液が……	응, 알았어…… …… 주인님의 것이 흘러내려…… 아까워, 주인님의 정액이……
これからいくらでも出してあげるんだから、そんなに気にする必要はないよ。	지금부터 얼마든지 싸줄테니까 그렇게 신경쓸 필요 없어.
そう言いながら、俺はまだまだ滾るモノを感じていた。	그렇게 말하면서 나는 아직도 끓어오르는 물건을 느끼고 있었다.
気持ち良くまどろんでいると、下半身に何か違和感を覚えた。	기분 좋게 졸고 있으면, 하반신에 뭔가 위화감을 기억했다.
……あれ？　気持ちいい……？	…… 어? 기분이 좋아……?
ご主人様……ああっ、素敵です……。あっ……はぁ……ん。	주인님…… 아앗, 멋집니다……. 앗…… 하아…… 응.
あ……おはようございます……。その、ご主人様の……ここが、すごく硬くてぇ……んっ……。	아…… 안녕하세요……. 그, 주인님의…… 여기가, 굉장히 딱딱해서…… 읏…….
あの、このまま……、わたしに、させて、ください……、ご主人様ぁ……。	저, 이대로……, 나에게, 시켜, 주세요……, 주인님…….
はい……、んっ……ご主人様の為に、がんばり、ます……。	네……, 읏…… 주인님을 위해서(때문에), 노력하겠습, 니다…….
ひゃああ！！　やぁん……くぅん……	아!! (이)나…… 쿠응……
うぅ……その……はしたなかった、でしょうか……？	…… 그…… 상스러웠다, 입니까……?
えへへ……はい！　喜んでもらえて嬉しいです……。	네에에…… 네! 기뻐해 받을 수 있어 기쁩니다…….
……もしかして、次も期待していいのかな？	…… 혹시, 다음도 기대해도 좋은 걸까나?
は、はい……。ご主人様が望むなら、いつでも……。	응, 네……. 주인님이 바란다면, 언제라도…….
はぁ……はぁ……。その、失礼、します……。	후~…… 하아……. 그, 실례, 합니다…….
はぁ……ん、ちゅ……、んっ、んっ……、あ、ご主人、さまぁ……んちゅ……。	하아…… 응, 츄……, 읏, 읏……, 아, 주인, 님…… 츄…….
……んっ、ちゅ……、ごしゅりん、さまぁ……ひもち、いい……れすかぁ……？　んっ……れろっ……。	…… 읏, 츄……, 종류응, 님…… 히 가져, 좋은…… 인가……? 읏…… 날름…….
うっ……、ああ、気持ちいいよ……。	……, 아아, 기분이 좋아…….
んくっ……ちゅ……あ……うれしい……れす……。ごしゅりん、さまの……すきぃ……。	응구…… 츄…… 아…… 기뻐…………. 종류응, 님의…… 비어 있고…….
ん、んん……んくっ、はぁ……ご主人様の味がしますぅ……。	응, 응응…… 응쿳, 하아…… 주인님이 맛이 납니다아…….
はい……あの、満足していただけましたか……？	네…… 저, 만족해 받을 수 있었습니까……?
……ご主人様のうそつき。	…… 주인님의 거짓말쟁이.
はい……、わたしはご主人様のものですから……。いつでも、何度でもさせていただきます……。	네……, 나는 주인님의 것이기 때문에……. 언제라도, 몇 번이라도 하도록 해 받습니다…….
えへへ……今日はぁ、ご主人様にいっぱいしてもらえるんですね……？	에헤헤…… 오늘은 주인님에게 잔뜩 해 줄 수 있네요……?
んぅ～っ……そうなのでしょうか……わたし、いつも思っている事をそのまま言っているだけですよう……	으응…… 그런 걸까요…… 전 항상 생각하고 있는 걸 그대로 말하고 있을 뿐이에요……
そっか。	그런가.
あのぉ……ご、ご主人様ぁ……お部屋に行く前に……んぅっ……ちょっとだけ……え、えっちなこと、してくれませんか……？	그…… 주, 주인님…… 방에 가기 전에…… …… 조금만…… 야, 야한 일 해주시지 않을래요……?
もう少しで部屋なのに……？	조금 있으면 방인데……?
んぅ～っ……もう、待ちきれなくて……シャワーにはいるじかんだって……お、惜しいですぅ……	…… 이제 못 참겠어서…… 샤워하는 시간도…… 아, 아까워요……
しょうがないな、じゃあ……	어쩔 수 없네, 그럼……
んっ……はぁ、はぁ……ご主人様、ご主人様ぁ……ご主人様の手……あ、熱いですぅ……くぅうん……	…… 하아, 하아…… 주인님, 주인님…… 주인님의 손…… 뜨, 뜨거워요…… ……
……触るだけでいいかな？　俺の、欲しくならない？	…… 만지기만 해도 되려나? 나를, 갖고 싶지 않아?
あ、あううっ……その、すっごく欲しいですけど……えへへぇ……この後もしてくれるから……今は触るだけでいいです……	…… 그, 엄청 갖고 싶지만…… 에헤헤에…… 이 뒤에도 해주니까…… 지금은 만지는 것만으로도 좋아요……
あ、後で、んっ……お部屋で……わたしのえっちなアソコ……その、はぁ、はううっ……ご主人様のでいっぱい苛めてくださいね……？	다, 다음에…… 방에서…… 제 야한 거기…… 그, 하아…… 주인님의 것으로 잔뜩 괴롭혀 주세요……?
……んっ、しないですよう……逆です……んっ、イっちゃったら、はぁ、はううっ……ご主人様にもっとしてほしいなっておもいますぅ……	…… 그렇지 않아요…… 반대에요…… 가 버리면, 하아…… 주인님이 좀 더 해 줬으면 좋겠다고 생각해요……
はぁ、はううっ！　はぁ、はぁっ、ご主人様ぁ、んぅっ、お、おと、しちゃってますねっ……はぁ、はぁ、ぬれてるから……！	하아………… 주인님…… 소, 소리, 나고 있네요…… 하아, 하아, 젖고 있으니까……!
……どんな音がなってるのかな？	…… 어떤 소리가 되어 있는 걸까?
あっ……ひぃっ！　あう、あの……！　くちゅくちゅって、なってます、アソコ、ご主人様にくちゅくちゅされてぇ、とろとろのえっちなの、たれてきてます……！	…… …… 질척질척하게 되어 있어요, 저기, 주인님에게 질척질척하게 돼서, 끈적끈적하고 야한 걸, 축 늘어뜨리고 있어요……!
ふえっ、はぁ、はううっ！　ご主人様ぁ、そこ、そこ、わ、わたしの弱いところですからぁ、はううっ、もっと、もっとですぅっ！	……………… 주인님, 거기, 거기는, 저, 저의 약한 곳이니까, 좀 더, 좀 더요!
しょうがないなぁ。	어쩔 수 없네.
んはぁあっ……！　はぁ、はぁあ！　やん、やぁあんっ、だめだめぇ、やぁあんっ！　恥かしいですぅ、もう、イっちゃいそうなんてっ……！	………시, 싫어……… 안돼 안돼……! 부끄러워요, 이제 가 버릴 것 같아요……!
いいよ、早くイっちゃえば？　……どうせこの後、いっぱい苛めてあげるんだから。	좋아, 빨리 가 버리지? …… 어차피 이 뒤에 잔뜩 괴롭혀 줄테니까.
はぁ、はいっ……はいいっ、ご主人様、ご主人様ぁっ、わたし、あううっ！　んぅっ、気持ちいいから、はぁ、はううっ……！	하아, 네…… 네엣, 주인님, 주인님, 저……! ……기분 좋아서, 하아……!
ふぁあぁあああ～～～～っ！！　はぁ、はひっ……くぅううううんっ……！	…………하아………………!
俺の手に、べっとりとした愛液が大量に付着する。	나의 손에 끈적끈적한 애액이 흠뻑 달라붙는다.
はぁ、はぁっ……んぅっ、あたま、ぼーっとして……ぐるぐる、します……はぁ、はひっ……くぅうんっ……	하아……  머리, 멍해…… 빙글빙글 해요…… 하아…… ……
はうううっ……わたしも、んっ、えっちなことしてくれるご主人様が……だいすきです……はぁ、はぁ、とってもしあわせです……	…… 저도 야한 걸 해 주는 주인님을…… 정말 좋아해요…… 하아, 하아, 너무 행복해요……
あのっ……えっと……イったけど……やっぱり……はやくしてもらいたいです……すぐに、お部屋に行きましょうね……？	저…… 음…… 갔지만…… 역시…… 빨리 하고 싶어요…… 바로 방에 갈래요……?
……うぅ～っ……ご主人様……あのぉ、さっき、一緒におしゃべりしている時に……ほかのめいどのこと、見ていませんでしたか……？	…… …… 주인님…… 저어, 아까 같이 이야기 하고 있을 때…… 다른 메이드를 보고 있지 않았어요……?
あぁ、すっごく綺麗なメイドがいたんだよ……お客様が連れてきていたのかな……？　ちょっと気になって。	아아, 엄청 예쁜 메이드가 있었어…… 손님이 데리고 왔던 걸까……? 조금 신경 쓰여서.
わたしとおしゃべりしている時に、ほかのめいどの事を見るのは……うぅ～っ……失礼だと思いますぅ……	저랑 이야기 하고 있을 때 다른 메이드를 보는 건…… …… 실례라고 생각해요……
ヤキモチ妬いちゃって……かわいいな。	질투해버리고…… 귀엽네.
むぅ、ご主人様のそういうところ……あんまり好きじゃないです……	……주인님의 그런 점…… 별로 좋아하지 않아요……
そのまま、なんと大胆にも俺のペニスを取り出してしまった。	그대로, 너무나 대담하게도 나의 페니스를 꺼내고 말았다.
……おへやにいくまえに、ちょっとおしおきです……ほかのめいどのこと、見ちゃイヤですぅ……	…… 방에 가기 전에, 조금 벌이에요…… 다른 메이드를 보면 싫어요……
はぁ……はぁ……れるっ……んぅんっ……くちゅっ……ご主人様ぁ、んっ……わたし、じょうずですよね……？	하아…… 하아…… …… …… …… 주인님…… 저, 잘해요……?
んぅっ、わたしは、こんなに……ちゅっ……れるぅっ……いっぱい、一生懸命してあげられるんですよぉ……？　ちゅう、ちゅっ……、れるっ……	……저는 이렇게…… …… …… 잔뜩, 열심히 해 줄 수 있다구요……? …………
ああ、分かってるよ……	아아, 알고 있어……
ちゅっ、ちゅっ……ちゅっ、ちゅっ、うわき、ひちゃいやです……んちゅっ、ちゅっ、わたし、いちばんになりたいれす……ちゅっ……ちゅっ……	…………  바람 피는 건 싫어요………… 저, 첫번째가 되고 싶어요…… …… ……
はぁ、はぅっ……くちゅっ！　んぅっ、んぅっ、ちゅっ、ほんとれすかぁ？　んちゅっ、ちゅうううっ、ぅうっ、ごひゅじんひゃまぁ……んちゅっ……	하아…………! ……저, 정말이에요? …………주인님…… ……
んぅっ、すき、すきすきぃ……んちゅっ、ちゅううっ！　いちばんだいすきです！　んちゅっ、れるぅ、はぁ、はぁ、ぐちゅっ……！	……좋아, 좋아, 좋아…………! 정말 좋아해요! …… 하아, 하아…………!
俺も大好きだよ。	나도 정말 좋아해.
それが嬉しくて、俺は思わずそう返事をしています。	그것이 기뻐서 나는 무심코 그렇게 대답을 하고 있습니다.
ぷはっ……んぅっ……えへへ……嬉しいです……もういちど、言って下さい……	………… 에헤헤…… 기뻐요…… 한 번 더 말해 주세요……
……大好きだよ。	…… 정말 좋아해.
……はぁ、はいっ……わたしもだいすきですぅ……えへへぇ……	…… 하아, 넷…… 저도 정말 좋아해요…… 에헤헤에……
ぐちゅっ、んぅっ、はぁ！　しゅき、んぅっ、ご、ごひゅじんひゃまぁ、んちゅっ、んぅっ、じゅるっ……はぁ、はぁ……	……하아! 좋아…… 주인님……………… 하아, 하아……
はぁ、はうっ……んぅっ、んぐっ、はぁ、はぁ、らひてくだひゃい、んぐっ、んぅっ、ぜんぶ、のんじゃいますからぁ……！	하아………… 하아, 하아, 싸 주세요…… 전부 마셔 버릴테니까……!
えへへぇ、ぐちゅっ、はぁ、はぁ、きかないでいいれすぅ、んぐちゅ、なんでも、飲んじゃいます、んぅ！　んぅっ、んぷちゅ、んぅうんっ！	…………하아, 하아, 묻지 않아도 돼요…… 뭐든지 마셔 버릴 거에요……! …………!
くっ……	……
んんん～～～っ！　んぅっ、はぁ、はぁっ……んくっ……んぅうんっ……	……하아………………
んぅうっ……んっ……えへへぇ……くちゅっ……くちゅ……はぁ、はううっ……	………… 에헤헤에………… ……하아……
ん、くっ……んぅんっ……こくっ……はぁ、はぁ……たくさん、ありがとうございます……	……………………하아, 하아…… 잔뜩, 감사합니다……
うっとりとした表情を浮かべると、ゆっくりと飲み込む。	황홀한 표정을 지으면서 천천히 삼킨다.
は、はい……なんらかぁ……えへへ……最後までわたしが全部しちゃいました……ご主人様、イヤでしたか……？	네, 네…… 뭔가…… 에헤헤…… 끝까지 제가 전부 해버렸어요…… 주인님, 싫었어요……?
……また、こんな風にいっぱいしてほしいな。	…… 또 이런 식으로 많이 해줬으면 좋겠네.
はい。ご主人様ならいくらでもします。大好きなご主人様の……その……いっぱい、おしゃぶりしますね……？	네. 주인님이라면 얼마든지 할게요. 정말 좋아하는 주인님의…… 그…… 잔뜩, 빨게요……?
この後の夜伽の事を考えると、俺は胸の高鳴りを抑える事ができなかった。	이 뒤의 밤시중을 생각하니, 나는 가슴의 두근거림을 참을 수가 없었다.
ご主人様、ご主人様っ……キスしてもいいですかぁ……？	주인님, 주인님…… 키스해도 될까요……?
ちゅ…………えへへっ……もっと、してください……ちゅ……ちゅっ……	…………에헤헷…… 좀 더 해 주세요………………
ちゅ……んちゅ……わたし、ご主人様とキスしてるときが、いちばん幸せです……ちゅ……んぅ……	………… 저, 주인님이랑 키스 하고 있을 때가 제일 행복해요………………
ちゅ、ちゅぴ……わたし……ずーっとこうしてたいです……ご主人様ぁ……だいすきです……んちゅ、ちゅぅ……	…… 저…… 계속 이렇게 하고 싶어요…… 주인님…… 정말 좋아해요…………
ずっとキスしてたら、エッチなことできないね。	계속 키스하고 있으면 야한 걸 못하잖아.
あ、あぅぅ……それはたいへんです……えっと、わたし、わたし……どうしたらいいんでしょうか……？	……그건 큰일이에요…… 음, 저, 저…… 어떡하면 좋을까요……?
キスだけでいいんじゃないの？	키스만으로 좋은 거 아냐?
やぁ……やです……キスもしたいけど……ご主人様と、えっちなこともしなくちゃ、やなんです……	시…… 싫어요…… 키스도 하고 싶은데…… 주인님이랑 야한 것도 하지 않으면 싫어요……
お願いです、ご主人様ぁ……わたしに、えっちなこと、してください……	부탁드려요, 주인님…… 저에게 야한 걸 해 주세요……
エッチなことって、どうすればいいのかな。	야한 일은 어떻게 하면 되는 걸까.
ご主人様の……いれてほしいです……わたしとせっくす、してください……	주인님의…… 넣어 주세요…… 저랑 섹스해 주세요……
酔っているのか、エッチな言葉もスラスラと出てくる。	취하고 있는 건지 야한 말도 술술 나온다.
わたし、ご主人様とせっくすしてるときも、キスしてるときと同じぐらい、幸せなんですぅ……	저, 주인님이랑 섹스하고 있을 때도, 키스하고 있을 때만큼 행복해요……
はぁ……はぁ……ですから、ご主人様の、いれてください……わたしを、幸せにしてくださいぃ……	하아…… 하아…… 그러니까 주인님의 거기, 넣어 주세요…… 저를 행복하게 해주세요……
……しょうがないな。	……어쩔 수 없네.
十分に濡れていたそこを、激しく責めたてる。	충분히 젖어 있던 거기를, 격렬하게 몰아세운다.
あぅ！　あ、やぁっ、んぅんっ……！　ご主人様ぁっ、あ、ありがとう、ございますぅ……はっ、あううっ……！	……………… 주인님, 가, 감사합니다아………………!
はぁ、はううっ……！　ご主人様の、おっきくて、はぁ、はぁ……わたし、いま、幸せです……はっ、あうっ……！	하아…………! 주인님의 거기, 커서, 하아, 하아…… 저, 지금, 행복해요…… …………!
こんなところで欲しがって……誰か来たらどうするの？	이런데서 원하다니…… 누가 오면 어떡하려고?
あうううっ……ど、どうしましょう……はぁ、やぁん……！　ごめんなさいぃ……ぜんぜん、かんがえてなかったです……	………… 어, 어쩌죠…… 하아……! 죄송해요…… 전혀 생각하지 않았어요……
はうぅっ、わたし、ご主人様のことしか、見えてなくてっ……はぁ、はぁ……！　ご主人様以外には、見られたくないですっ、きゃうぅっ……！	……저, 주인님밖에 보이지 않아서…… 하아, 하아……! 주인님 외에는 보여지고 싶지 않아요…………!
思いつかなかったのか……	생각하지 못했던 걸까……
それだけ俺に夢中だったと思うと、ますます興奮が高まってくる。	그만큼 나에게 열중했다고 생각하니 더욱 더 흥분이 높아진다.
なら、早く終わらせないとね。	그럼, 빨리 끝내지 않으면 말야.
ひぁっ！　あん、ああっ、ごめんなさい、ごめんなさいご主人様ぁっ、わたし、おさけ、のみすぎちゃって、はううっ！	………… 죄송해요, 죄송해요 주인님, 저, 술, 너무 마셔 버려서……!
ああっ、んぅっ！　でもわたし、しあわせなんですっ、はぁ、はぁ、ご主人様となら、どこでも、せっくすしたいですっ……！	…………그치만 저, 행복해요, 하아, 하아, 주인님이라면 어디서라도 섹스하고 싶어요……!
ですから、このまま最後までぇっ、はぁ、はぅ、わ、わたしの奥に、あついの、くださいぃっ……ひぁあっ！	그니까 이대로 끝까지, 하아…… 제, 제 안쪽에 뜨거운 걸 주세요…… ……!
激しい抽送を繰り返し、俺もすぐに堪えられなくなってくる。	격렬한 삽입을 반복하면서, 나도 곧 참을 수 없게 된다.
やああっ、ん、ひうぅっ！　はぁ、激しくて、わたしのあそこ、やけどしちゃいますっ、や、んっ、はぅ、あああっ！	………………하아, 격렬해서, 제 거기, 너무 뜨거워요………………!
ご主人様っ、ご主人様ぁっ！　はうぅ、わたしもう、もうだめですっ、おかしくなっちゃいますっ、んあ、あううっ、んく、ひぁああっ！	주인님, 주인님! ……저 이제, 이제 안돼요, 이상해져 버려요………………!
俺もそのまま奥のほうへと、熱い塊を吐き出した。	나도 그대로, 안쪽으로 뜨거운 덩어리를 뿜어냈다.
ひゃっ、やぁあっ！　ふぁ、やああああぁぁっ……！	야앗! …… 야아아아아앗……!
やぁ、あうぅっ……はぁっ、やぁん……ご主人様の、せいえき……あったかいです……しあわせですぅ……えへへ……	…………………… 주인님의 정액…… 따뜻해요…… 행복해요…… 에헤헤……
はぅぅ……そのぅ……このあとも、もうちょっと……したいです……ご主人様、いいですかぁ……？	…… 그…… 이 뒤에도 좀 더…… 하고 싶어요…… 주인님, 괜찮을까요……?
甘えるような仕草を見て、俺はまた劣情を催すのだった。	어리광부리는 것 같은 행동을 보고, 나는 또 성욕을 끌어올리는 것이었다.
はううう……ご主人様ぁ、あのぉ……からだあつくって……んぅっ……ぼーっとしちゃうんです……	…… 주인님, 저어…… 몸 뜨거워서………… 멍해졌어요……
ちょっとだけでもいいのですけれど……わたしのからだ、さわってください……	조금만이라도 좋아요…… 제 몸, 만져주세요……
もう少しで部屋だよ？	조금 있으면 방인데?
うぅっ……でも、ずーっとエッチなことかんがえてたら……はぁ、はううっ……ご主人様ったらぁ……	……그래도 계속 야한 걸 생각하고 있었더니…… 하아………… 주인님도 참……
……自分でしてみたら？	……스스로 해 보는 건?
ふえっ……？　はぁ、はうっ……そ、そーですよね……くぅん……でも、ご主人様、いいんですか……？	…… 하아…… 그, 그러네요………… 그치만 주인님, 괜찮아요……?
俺は見てるだけになるけど。	난 보고 있을 뿐인데.
うぅっ……さみしーです……でも、んっ……我慢、できないからぁ……	…… 외로워요…… 그치만…… 못 참겠으니까……
はぁ……んっ……えへへ……触っても無いのに……濡れちゃってました……はぁ、はううっ……	하아…… …… 에헤헤…… 만지지도 않았는데…… 젖어 버렸어요…… 하아……
……ひょっとして、ずっと前から濡れてたのかな？	……혹시 아까 전부터 젖어 있었던 거야?
はぁ、はうっ……そ、そうです、その……お酒飲んで、ぼーっとしちゃった時からぁ……はぁ、はぁっ……くぅんっ……	하아…… 마, 맞아요, 그…… 술 마셔서 멍하게 됐을 때부터…… 하아…………
ごめんなさい、ご主人様……はぁ、はうっ……この後、されちゃうんだって思ったら、ずっとドキドキしちゃってぇ……	죄송해요, 주인님…… 하아…… 이 뒤에 한다고 생각하니 계속 두근거려서……
俺と話しながら、俺にされる事を想像してたんだ？	나랑 이야기하면서 나랑 하는 일을 상상하고 있었어?
は、はい……ご主人様に、何されるのかな、とか……どんなエッチな事、してくれるんだろうって……はううっ……	네, 네…… 주인님에게 뭘 해드릴까, 라든지…… 어떤 야한 걸 해주실까, 라고…………
……もっと、激しくオナニーしたい？	…… 좀 더 격렬하게 자위하고 싶어?
は、うぅっ……どうしてぇ……わかるんですかぁ……？　はぁ、はぁっ……は、はい……激しく、したいです……もっと、くちゅくちゅって……アソコ、擦りたいですぅ……！	…… 어떻게…… 아셨어요……? 하아…… 네, 네…… 격렬하게 하고 싶어요…… 좀 더 질척질척하게…… 거기, 비비고 싶어요……!
はぁ、はううっ、ありがとう、ございますぅ……はぁ、はぁ、んぅっ、はぁ、しちゃいますね、ご主人様っ……！　ぁあ、あううっ……！	하아…… 감사, 합니다…… 하아, 하아…… 하아, 해 버렸어요, 주인님……! 아아…………!
んぁっ、はぁ、はううっ、ひぅうっ！　はぁ、あうっ、あうっ……ご主人様ぁ。い、イって、いいですかっ……？	……하아…………하아……………… 주인님. 가, 가버려도 될까요……?
はぁ、はうっ、んぅっ、わたし、ご、ご主人様のまえでぇ、はぁ、はううっ、クリトリスさわってるのぉ、はぁ、はううっ……！	하아………… 저, 주, 주인님의 앞에서, 하아…… 클리토리스 만지고 있어, 하아…………!
は、はうう、そうですぅ、ご、ご主人様にされたいなって、ご主人様にいじってほしいなっておもってぇ、はぁ、はううっ！	…………그래요, 주, 주인님으로 하고 싶어서, 주인님에게 만져졌으면 하고 생각해서, 하아……!
はぁ、ごめんなさいぃっ、はぁ、はううっ！　んぅっ、んぅっ、イ、イっちゃいますっ、イかせてくだひゃい、んぅっ！　んっ……！	하아, 죄송해요, 하아! …………가, 가 버려요, 가게 해주세요…………!
ひゃ、んぅっ……！　んくっ！　イっちゃいますぅううううっ！！	………… 가 버려요오오오오옷!!
あっ……ひっ……ひぃいいんっ……！　はぁ、はぁっ……す、すごいれしゅう……はぁ、はううっ……	…… …… …… 하아…… 어, 엄청났어요…… 하아…………
んぅっ……おさけと、お、おなにーでぇ……はぁ、はううっ……もう、何も考えられない……ですぅ……はううん……	…… 술이랑 자위로…… 하아…… 이제 아무 생각도 못하겠…… 어요…………
は、はう……そうでしたぁ……これから、もっとご主人様に気持ちよくしてもらうんですよね……えへへぇ……	………… 그러네요…… 지금부터 좀 더 주인님에게 기분 좋게 되겠네요…… 에헤헤에……
はぁ、はぁ……わたし、その……何でも感じちゃうと思いますぅ……はぁ、はぁ、え、えっちすぎです、くぅうんっ……	하아, 하아…… 저, 그…… 뭐든지 느껴 버릴 거라고 생각해요…… 하아, 하아, 너, 너무 야해요…………
そう呆れたような声を出しながらも、俺はかなり興奮しているのだった。	그렇게 기가 막힌 것 같은 소리를 하면서도, 나는 꽤 흥분하고 있는 것이었다.
あ……あの……ごめんなさぁい……ご主人様、先にお部屋にいってくれませんか……？	아…… 저…… 죄송해요…… 주인님, 먼저 방에 가 주시지 않을래요……?
どうしたの？	왜 그래?
お、おさけ、いっぱいのんじゃいましたから……ちょっと、おなかむずむずして……	수, 술을 너무 많이 마셔서…… 조금 배가 근질근질해서……
おしっこ、したいんだ。	오줌 누고 싶은 거네.
はい……おといれ、いってくるので……	네…… 화장실 갔다올테니……
……ほら、誰も見てないからさ、ここでしちゃえばいいんじゃないかな？	…… 자, 아무도 안보니까 여기서 해 버리면 좋지 않을까?
あう、でも……汚いです、そんな……	……그치만…… 더러워요, 그런……
ご主人様の命令が聞けないのかな？	주인님의 명령을 듣지 않는 거야?
分かり、ましたぁ……はぁ……はううっ……	알겠, 어요…… 하아…… ……
だれかこないか、みていてくださいね……？　はうう、ご主人様以外にはみられたくないですから……	누가 오지는 않는지 보고 있어 주세요……? ……주인님 외에는 보여지고 싶지 않으니까요……
……見てもらうのも悪くないかもね。	…… 보여지는 것도 나쁘지 않을지도.
はううっ……ご主人様のいじわる……うぅっ、あんなにしたかったのにぃ……お、おしっこでないですぅ……くぅんっ……	………… 주인님은 짓궂어………… 그렇게 하고 싶었는데…… 오, 오줌이 아닙니다아…………
ご、ご主人様ったら……その、アソコ見ないで下さい……おしっこ、出るところ、そんなに見ないで……	주인님도 참…… 그, 거기 보지 말아 주세요…… 오줌 나오는 곳 그렇게 보지 마……
見られたほうが、気持ち良い癖に……俺が手伝ってあげようか？	보여지는 편이 기분 좋은 주제에…… 내가 도와 줄까?
あう、んぅっ……わ、分かりましたからぁ……はう、い、いたずらはしないでくださいっ……んんぅ～～っ……	………… 아, 알겠어요………… 자, 장난은 하지 말아 주세욧………………
あ、あうっ……んぅっ、おしっこ、出そうです……はぁ、はぁうっ……はぁ、はううっ……	……………… 오줌, 나올 것 같아요…… 하아………… 하아…………
あっ……あううううっ……はうううっ……とまらないですっ……	………………………… 멈추지 않아요……
はぁ、はぁ、はぁ……あぅうっ……ご主人様、出しましたぁ……はう、こ、これでいいですかぁ……？	하아, 하아, 하아……………… 주인님, 쌌어요…………  이, 이걸로 됐죠……?
これから夜伽だっていうのに、こんな所でおしっこしちゃうなんてね。	지금부터 밤시중이라고 했는데, 이런데서 오줌을 눠 버리다니.
は、はううぅ……ごめんなさい……えっと、その……この後……おしおきですか……？	………… 죄송해요…… 음, 그…… 이 뒤에…… 벌이에요……?
分かってるなら話は早いね。	알고 있다면 이야기는 빠르네.
は、はい……分かりました、ご主人様……あの、わたし、いけない子ですから……好きに、してください……	네, 네…… 알겠습니다, 주인님…… 저기, 저, 못된 아이니까…… 마음대로 해 주세요……
その瞳には、これからの夜伽の期待が込められていた。	그 눈에는, 앞으로의 밤시중에 대한 기대가 담겨 있었다.
……あの、ご主人様……えっとですね、その……	…… 저, 주인님…… 그러니까요, 그……
あう、はい……き、キス……だけでもして頂けませんか……？	…… 네…… 키, 키스…… 만이라도 받을 수 없을까요……?
『キスして頂く』なんて言わなくてもいいのに。	『키스 받는다』라고 말하지 않아도 되는데.
ちゅっ……ちゅっ……んぅっ……ご主人様ぁ……ちゅっ……んちゅっ……好きです、好きですぅ……ちゅっ、ちゅっ……	……………… 주인님……………… 좋아해요, 좋아해요오…………
部屋はすぐそこだけど。	방은 바로 저기인데.
は、はい……わかって、んちゅっ、いるのですけど……ちゅっ……えへへ……ちょっとだけ、先に……キスしてほしいなって……	네, 네…… 알고…… 있는데요………… 에헤헤…… 조금만, 먼저…… 키스 해 주셨으면 좋겠다고……
ちゅっ……んぅうっ……ちゅっ……んぅっ……ちゅっ……ご、ご主人様ぁ……ちゅっ……れるっ……えへへっ……ちゅっ……	…… …… …… …… …… 주, 주인님…… …… …… 에헤헷…… ……
ん、えっと……その、もっとエッチなキス、してほしいです……	응, 음…… 그, 좀 더 야한 키스, 해 주셨으면 좋겠어요……
はぁ、んちゅっ……じゅるるっ……はううっ……ご主人様ぁ、んちゅっ……ごめんなさい、わたし、はぁ、はううっ……じゅるるぅ……	하아…………………… 주인님…… 죄송해요, 저, 하아………………
俺の舌の裏に潜り込んで、擦り上げ、垂れた唾液を喉を鳴らして飲み込む。	나의 혀 뒤에 기어들어서 쓸어 올리고는, 늘어진 타액을 소리내며 삼킨다.
はぁ、んくっ……んぅっ……おいし、れすっ……んちゅっ、はぁ、はぁ……んちゅっ、ご主人様の味します……ちゅっ、だいすきです……	하아……………… 맛있, 어요……  하아, 하아……  주인님의 맛이 나요…… 정말 좋아해요……
はぁ、はぁ……あううっ、あの、あのっ……ちゅぷっ……ご主人様ぁ、その……わたし、わたし……	하아, 하아……  저기, 저기…… …… 주인님, 그…… 저, 저……
……このまま、したくなった？	…… 이대로 하고 싶어졌어?
ん……んぅっ……は、はうっ……はい……で、でも……あの、ここじゃ、はずかしいです……	……………… 네…… 그, 그치만…… 저, 여기는 부끄러워요……
こんなにエッチなキスしたのに？	이렇게 야한 키스 했는데?
……うぅっ……はやく、わたしのこと、その……慰めてください……はぁ、はぁ、どきどきしておかしくなりそうですからぁ……	………… 빨리 저를, 그…… 위로해 주세요…… 하아, 하아, 두근거려서 이상해질 것 같으니까요……
ここで始めてしまうのも一興だけど、俺達はひとまず部屋に急ぐのであった。	여기서 시작하는 것도 재미있겠지만, 우리들은 일단 방으로 가는 것을 서두르는 것이었다.
ご主人様、動かないでくださいね……？	주인님, 움직이지 마세요……?
あ、あの……いいですか？　じゃなくて、もう、その……ご主人様をこんな格好にさせちゃいましたけど……	저, 저기…… 괜찮으세요? 가 아니고 벌써 그…… 주인님을 이런 모습으로 만들어 버렸지만요……
ちゅ……ちゅうっ……えへへ……ちゅっ、ちゅっ……ちゅぅっ……ごしゅじんさまも、がちがちですね……	…………에헤헤……………… 주인님도 딱딱하네요……
……部屋に行ってから、シャワーを浴びようと思っていたので、俺のペニスはそこまで綺麗でないというのに。	…… 방에 가서 샤워하려고 했는데, 내 페니스는 그리 깨끗하지 않다고 말했잖아.
その、洗ってないけど……	그, 안 씻었는데……
あう……そうでしょうか？　んちゅっ……ご主人様の匂いがとてもつよくて、ちゅっ……ちゅっ……わたし、すきですよ……？	…… 그런가요? …… 주인님의 냄새가 너무 진해서………… 저, 좋아한다구요……?
ちゅっ、ちゅっ……えへへ、ちょっとだけ、おしっこのあじ……するかもです……ご主人様のなら、平気ですぅ……ちゅ……ちゅ……	…… 에헤헤, 조금이지만 오줌의 맛이…… 날지도요…… 주인님의 것이라면 괜찮아요………………
ぐちゅっ、ぐちゅっ……んちゅっ……はぁ、ご主人様ぁ、んぅ、我慢できなくなっちゃって……ちゅっ、ちゅぷっ……	…… …… 하아, 주인님…… 못 참게 됐어요………………
それに、ちゅっ……ちゅっ……ご主人様がよろこんでくれるかなって思って、ちゅっ、ちゅぷっ……ぐちゅっ……！	그리고………… 주인님이 기뻐해주실 거라고 생각해서………………!
その度に、頬を綻ばせて、美味しいと表情で伝えてくれる。	그때마다 뺨을 부풀려서 맛있다는 표정을 보여 준다.
ぐちゅっ、はぁ、はぁ、ちゅぷ、んぅっ！　えへへ、好き、好きぃ、んちゅっ、れるぅっ、はぁ、はぁ、んぅうんっ……！	……하아, 하아…………! 에헤헤, 좋아, 좋아아………… 하아, 하아…………!
おひっこのあじも、んちゅっ、はうっ、あせのにおいも、はぁ、はぁ！　んぐちゅっ、んんん～～！　ぜんぶすきぃ、はぁあんっ……！	오줌 맛도…… 땀 냄새도, 하아, 하아! …………전부 좋아…………!
その濃厚な奉仕に、俺は少し情けないけれど、すぐに上り詰めてしまう。	그 농후한 봉사에, 나는 조금 한심하지만 곧바로 끝까지 올라와 버린다.
んっ……はぁ、はぁあ、ぐちゅっ、ごひゅじんひゃまの、ひくひくひてますっ、んぐちゅっ……れるぅ！　はぁ、はうっ、らして、らしてぇっ！	……하아, 하아아…… 주인니메 거기 움찔움찔하고 이써요………… 하아…… 싸줘 싸줘엇!
んぅっ、んぷっ……！　んぅううっ……ごひゅじんひゃまの……んぅっ……せいえきぃ……	……………… 주인니메………… 정액……
んくっ……こくっ……えへへ……はぁ、はぁ……おいしかったです……んぅん……	…………에헤헤…… 하아, 하아…… 맛있었어요…………
あう、でも、その……こんなに出しちゃったら、夜伽の時に、わたしにくれなくなっちゃうのでしょうか……？	……그치만 그…… 이렇게 싸 버리면 밤시중 때는 저한테 주지 못하게 되는 걸까요……?
……はは、お手柔らかに頼むよ。	…… 하하, 살살 부탁해.
ごめんなさい、あの……ご主人様にしてあげたいなって思ったら、我慢できなくって……続きは、お部屋で……ですね♪	죄송해요, 저…… 주인님이랑 하고 싶다고 생각하니 못 참겠어요…… 다음은 방에서……네요♪
その笑顔に、俺は打ち抜かれてしまうのであった。	그 웃는 얼굴에 나는 함락되는 것이었다.
ご主人様、あの……キス、してください……	주인님, 저…… 키스, 해주세요……
ちゅっ……ちゅ……んぅっ……ちゅっ……ごめんなさい……すぐに、その……ちゅっ……したくなっちゃって……	……………………죄송해요…… 바로 그………… 하고 싶어져서……
んちゅっ……じゅるぅっ……はぁ、はぁっ……ちゅ、ちゅううっ……はぁ、はううっ……ご主人様ぁ、ご主人様ぁ……	………… 하아……………… 하아………… 주인님, 주인님……
もっと他にしてほしいことがあるかのような、物欲しそうな顔だった。	좀 더 다른 것도 해줬으면 하는 것 같은, 탐이 나는 듯한 얼굴이었다.
……どうかした？	……왜 그래?
気付いているけれど、先回りして言うのも面白みにかける。	알고 있지만, 먼저 말해버리는 것도 재미있다.
……ご主人様ぁ、あの……分かってください……えっと、わたし……	…… 주인님, 저…… 이해해 주세요…… 음, 저……
どうして部屋まで待てないのかな？	왜 방까지 못 기다리는 거야?
夜伽に誘われた時から、き、期待して……最初は、その……キスしてくれたら、我慢できるかなって……	밤시중에 불렸을 때부터 기, 기대해서…… 처음엔 그…… 키스하면 참을 수 있을까 해서……
……だめ、ですよね。その……我慢できるはずないです……	…… 안되, 네요. 그…… 참을 수 있을 리가 없어요……
どうしたい、かな。	어떻게 하고 싶은, 거야.
…………あの……可愛がって下さい……	………… 저…… 귀여워해 주세요……
俺は……どうすればいいのかな？	난…… 어떡하면 되는 거야?
……あ、あう……せ、セックス、してください……ご主人様、わたしと、えっちしてください……	…… …… 세, 섹스, 해주세요…… 주인님, 저랑 섹스해 주세요……
俺はそこまで言わせても、ペニスを入れなかった。	나는 거기까지 말하게 하고도 페니스를 넣지 않았다.
ご主人様の、あの、がちがちになっている、ソレ……アソコに、入れて下さい……はぁ、はううっ……ご主人様ったらぁ……	주인님의, 저, 딱딱하게 되어 있는 그거…… 거기에 넣어 주세요…… 하아………… 주인님도 참……
はぁ……あうううっ……ご主人様の太いのがちがちなの……わたしの……その、触ってもいないのに……濡れちゃってるアソコに入れてください……！	하아………… 주인님의 굵고 딱딱한 거…… 저의…… 그, 손대지도 않았는데…… 젖어 버린 거기에 넣어 주세요……!
そのまますぐ、俺は激しい抽送を始める。	그대로 바로, 나는 격렬한 삽입을 시작한다.
あうっ！　やぁ、やぁんっ！　ご、ご主人様、はげしっ……はぁ、はううっ……！　あううっ……！	………………주, 주인님, 격렬해…… 하아………………!
だって、いっぱい濡れてるから。	그거야 잔뜩 젖어 있으니까.
はぁ、はぅうっ……んぅっ、は、はいっ、わたし、わたし、んぅんっ……！　いっぱいアソコ、その、濡らしちゃってました、はぁ、はぁっ……！	하아………… 네, 네, 저, 저…… 잔뜩 거기를, 그, 젖게 하고 있었어요, 하아…………!
あうう、んぅっ、き、キスする前は、ちょっとだけだったのにっ……はぁ、はぁ！　ご主人様とキスしたら、はああっ、いっぱい濡れて……！	…………키, 키스 하기 전에는 조금뿐이었는데…… 하아, 하아! 주인님이랑 키스 했더니…… 잔뜩 젖어서……!
少し奥に突くだけで、愛液はどくどくと重力に引かれて垂れてしまう。	조금 안쪽을 쑤시는 것만으로도, 애액이 중력에 이끌려 질질 늘어져 버린다.
ご、ごめんなさいぃ……はぁ、はううっ……ごめんなさい、ご主人様ぁ、はぁ、はううっ……わたし、こんなのぉ、エッチ過ぎです……	죄송해요…… 하아………… 죄송해요, 주인님, 하아………… 저, 이런 건 너무 야해요……
お部屋まで我慢できない、はぁ、はぁ、はしたないメイドですぅ、はぁ、はうっ……！	방에까지 가는 것도 못 참는, 하아, 하아, 버릇없는 메이드입니다아, 하아…………!
俺はお仕置き、と言わんばかりに抽送を激しくする。	나는 벌, 이라고 하듯이 삽입을 격렬하게 한다.
あひっ！　ああああ、はげし、はげしいですっ、んぅうんっ、ご主人様、ご主人様ぁっ♪	………………격렬해, 격렬해요…… 주인님, 주인님♪
はぁ、はぁ、やっぱり、わたしぃ、アソコのなかぁ、ふといのでぐりぐりされるのが、いちばんすきなんですっ……！	하아, 하아, 역시, 전, 거기 안쪽을 굵은 걸로 둥글둥글하게 하는 걸, 제일 좋아해요……!
あああ、んぅっ、はぁ、はぁ、なんか、わたしのあそこの、い、一番奥も、ご主人様の先にぃ、くちゅくちゅって、当たってますぅ……！	아아아…… 하아, 하아, 뭔가, 제 거기, 가, 가장 안쪽도, 주인님의 끝으로 질척질척 닿고 있어요……!
ご褒美といったほうが、正しい。	포상이라고 하는 편이, 맞겠다.
はぁ、はううっ、は、はいっ、あううっ、そっかぁ、この後も、はううっ！　ご、ご主人様にずっと、一晩中、えっちなこと、されちゃうんだ……！	하아…… 네, 네…… 그런가, 이 뒤에도……! 주, 주인님에게 계속, 밤새 야한 일을 당해버리는 거야……!
あぁあ、あぅっ！　はぁ、はぁっ！　ご、ご主人様ぁああ～っ！！	아아아……! 하아……! 주, 주인니이이임!!
搾り取られるような、奪い取るような締め付け。	짜내려는 것 같이, 빼앗으려는 것 같이 붙잡는다.
はぁあっ……ご、ご主人様がぁ……♪　せいえき、くれました……えへへ……わたし、おねだりして……良かったですぅ……	…………주, 주인님이……♪ 정액 주셨어요…… 에헤헤…… 저, 졸라대길…… 잘했어요……
……はい、えへへ……ご主人様が、エッチなメイドにしたんですよ……？　だから、その……この後も、あいしてください……♪	……네, 에헤헤…… 주인님이 야한 메이드로 만든 거에요……? 그니까 그…… 이 뒤에도 사랑해 주세요……♪
ご主人様……えっと、その……お部屋につく前に……	주인님…… 음, 그…… 방에 도착하기 전에……
…………ここで、わたしの事、苛めてくれませんか……？	…………여기서 저를 괴롭혀 주시지 않을래요……?
ご、ごめんなさい。その……だって、ご主人様とお話している時から、はやくはやくって思っちゃって……え、えへへ……	죄, 죄송해요. 그게…… 그치만, 주인님이랑 이야기 하고 있었을 때부터, 빨리, 빨리 하고싶다고 생각해서…… 에, 에헤헤……
エッチなメイドに、はう……い、いらまちお、してください……	야한 메이드에게………… 이라마치오를 시켜주세요……
ぐぷっ……んぉっ……んぅううっ……んぐぅうん……ごひゅじんひゃまぁ……んぐうぅうっ……	……………………주인님…………
んぐっ、んぉっ……んぅううっ……ごめんなひゃいいっ……んぐっ、んぷぅっ……こんなめいどれぇ、んぐっ、んぉ、んぷぅっ……んぇえ……	……………… 죄송해요………… 이런 메이드라서 ………………
はぁ、はぅっ……ぐぶっ……んぐ、ぶっ……おひおきひてくだひゃいいっ……んぐっ、んぅうんっ……んぅ、んぷっ……ごひゅじんひゃま……	하아……………… 벌을 주세요……………… 주인님……
ん、ぐっ……！？　んぷっ！　んぅっ！　んぅっ、ひゅぐっ！　はぁ、はぁ、おひおき、んんんぅ～っ！	………………하아, 하아…………!
……あんまり嬉しそうにされても、お仕置きって感じがしないな。	……너무 기쁜듯이 받으니 벌이라는 느낌이 안드네.
ぷ、はっ……はぁ、はうっ、ご、ご主人様だけなら……はい……すきです……のどのおく犯されると……はあ、すきすきって、思っちゃいます……	…… 하아…… 주, 주인님에게라면…… 네…… 좋아해요…… 목 안쪽을 범해지면…… 하아, 좋아좋아 라고 생각해요……
ご主人様が、わたしなんかで興奮して……はぁ、はぁ、こんなに大きくしてくれてるんだって思うと、わたし、しあわせです……	주인님이 저 따위로 흥분해서…… 하아, 하아, 이렇게 크게 해주신다고 생각하니 저는 행복해요……
んんん～～～っ！！　んぐぅ、うぇええっ、んぷっ、んぅうんっ！　はぁ、はぁ、ひあわへれすぅっ！	…………………………하아, 하아………!
いくら苛めてもお仕置きにならないな、この淫乱メイドは！	아무리 괴롭혀도 벌이 안 되네, 이 음란 메이드는!
んんんぅうんっ！　ごめんなひゃい、ごめんなひゃいいっ、んぐっ、んんんぅっ、いんらんでぇ、んぐっ、うぇえ、んぷっ、んんん～～～っ！！	…………죄송해요, 죄송해요………………음란해서……………………!!
んぐ、ぷっ、んぅっ！　んぅっ、んぁああ！　ひぅうっ、らしてぇ、んぐっ、んぅうんっ！　んどおくれ、んぐっ、んんぅうう～！！	……………… 싸줘……………………!!
んぐっ……！？　んぅっ、んぐぅうっ……！！　ごほっ……ごほっ……	………………콜록…… 콜록……
……分かるよね。	……알고 있겠지.
んっ……んくっ……んくっ……こくっ……んぷっ……はぁ、はぁ……えへへ……いっぱい、です……	………………………… 하아, 하아…… 에헤헤…… 잔뜩, 나왔네요……
こんなわたしに、んぅっ、たくさんの精液を注ぎ込んでくださって……あ、ありがとうございます……	이런 저에게…… 잔뜩 정액을 쏟아 주셔서…… 가, 감사합니다……
……さっさと立って、部屋で続きをするから。	……빨리 일어서, 방에서 계속 할거니까.
は、はい……♪　わたしのお願いに答えてくださって……お仕置きしてくれて……とても、しあわせです……	네, 네……♪ 제 부탁을 들어주셔서…… 벌을 주셔서…… 너무 행복해요……
どういうつもり？	왜 그래?
えっと……その、ご主人様ぁ……ここでしてください……お部屋まで待てません……	음…… 그, 주인님…… 여기서 해주세요…… 방까지 못 기다리겠어요……
まだ、濡れてないけど……	아직 젖지 않았는데……
え、えっと……その、痛いの、好きなので……えへへ……	으, 음…… 그, 아픈 거 좋아해서…… 에헤헤……
あの、あうう……このままだと、ご主人様にされちゃうって思って、濡れちゃいますから……はやくぅ……	저…… 이대로라면, 주인님이랑 한다고 생각하면 젖을 테니까요…… 빨리……
んぁあああっ……！　はぁ、はぁっ、はううっ、くるし、です……んぁああんっ……♪	………… 하아……괴로, 워요………………♪
はぁ、はぁっ……は、ぅううっ……わたし、あうっ……ん、くっ……んぅうんっ……いたくて、興奮しますぅ……	하아……………… 저, 저……………………… 아파서, 흥분해요……
すごいな、締め付けが……	엄청나네, 조임이……
あ、あの……はぁ、はうっ、えっとぉ、叩いて、くれたらぁ……も、もっと、アソコ、きゅーって、なりますよ……？	저, 저기…… 하아…… 음, 때려주면…… 조, 좀 더, 거기, 감동해요……?
ご主人様が良かったら……はぁ、はぁ、お、お尻……叩いてぇ……はぁ、はううっ……	주인님이 괜찮다면…… 하아, 하아, 어, 엉덩이…… 때려줘…… 하아……
そう言われて、俺は従ってしまう。	그렇게 말해서, 나는 따른다.
あっ……！？　ひぃっ！　ひぃいいんっ！　ご、ご主人様ぁ、はぁ、はうっ！　叩かれちゃったぁ……♪	앗……!? ………… 주, 주인님, 하아……! 맞아 버렸다아……♪
はぁ、はううっ、んぅっ、ご、ご主人様ぁ、どうですか、はぁ、はううっ、きもちいいですか……？	하아………… 주, 주인님, 어때요, 하아…… 기분 좋으세요……?
それなら……	그럼……
あうっ！　あぅうっ……！　やぁ、やぁあんっ！　はぁ、はぁっ、ご主人様、はげしいです、はぁ、あううっ！	……………………하아…… 주인님, 격렬해요, 하아……!
……そう？　挿れてからすぐに濡れだして、叩きながらエッチしたら、もうぐちゅぐちゅになってるけど？	…… 그래? 넣으니까 바로 젖기 시작해서, 때리면서 섹스하니까 이제 질척질척하게 됐는데?
きゃうっ、きゃぅううっ……！　はぁ、はぅっ！！　だって、ご、ご主人様がしてくれるからぁ、はぁはううっ……！	…………………………그치만, 주, 주인님이 해 주시니까………………!
やぁ、やぁあんっ！　はぁ、はひっ、お尻、じんじんしちゃってますっ……！　はぁ、はぁ、ご主人様、ご主人様ぁ……！	………………하아…… 엉덩이, 얼얼해졌어요……! 하아, 하아, 주인님, 주인님……!
はぁ、はぅっ、んぅっ、ひぐっ、こんな、お、お部屋に行く途中なのにっ……！　あぅうっ！　わたし、わたしっ……！	하아……………… 이런, 바, 방에 가는 길인데……! ……저, 저……!
本当だよ、ご主人様も大変だって分かってる？	정말이야, 주인님도 큰일이란 거 알고 있어?
あはぁ、はぁ、やぁあああんっ！　ごめん、なさいっ！　あううっ、あううっ……！！　ご主人様ぁ……！	……하아………… 죄송, 해요! ……………… 주인님……!
あ、あのっ、はぁ、はううっ、さ、最後まで、最後までっ……！　し、してくれますよね……？	저, 저기, 하아…… 끄, 끝까지, 끝까지……! 해, 해 주실 거죠……?
注文の多いメイドだな……ま、してあげるよ。	주문이 많은 메이드네…… 뭐, 해 줄게.
ぁあっ、あぎっ、はぁ、はぁあっ、あ、ありがとうございますっ、んぅっ！　んくっ、はぁ、はうううっ……！	……하아…… 가, 감사합니닷……! ………하아……………!
しょうがないから、ほらっ……	어쩔 수 없다니까, 자……
んぁっ、出てますっ……！　んぅっ！　んぁあ～～～～っ……！！	……나와요……………!
ふぁああ……アソコも、おひりも……んぅうん……火傷しそうなぐらい……熱いままです……んぅうんっ……	…… 거기도, 엉덩이도………… 너무…… 뜨거워요…… ……
はぁ、はぁ、ご主人様も、こんなに出してくれたんですね……？　あうう、エッチで、お部屋まで待てないわたしに……こんなにくれるなんてぇ……	하아, 하아, 주인님, 이렇게나 싸주신 거네요……? ……야해, 방까지 못 기다린 저에게…… 이렇게나 싸주다니……
は、はい……おねだりに答えてくれてぇ……ありがとう、ございました……だいすきな、ご主人様……	네, 네…… 부탁한 걸 해주셔서…… 감사합, 니다…… 정말 좋아하는 주인님……
ご主人様がよろしければ、その……この後も、いっぱい苛めてくださいね……えへへ……	주인님이 괜찮으시다면 그…… 이 뒤에도 잔뜩 괴롭혀 주세요…… 에헤헤……
あれだけ出したというのに、俺はすでに腹の奥に何かが滾るのを感じていた。	그만큼이나 쌌는데, 나는 벌써 배 안쪽에서 뭔가가 끓어오르는 것을 느끼고 있었다.
ふふっ……ご主人様のおちんちん、相変わらずたくましいですね。	후후……주인님의 자지, 변함 없이 씩씩하네요.
朝、下半身に優しい刺激を受け、緩やかに目が覚める。	아침, 하반신에 상냥한 자극을 받아 완만하게 깨어난다.
あら、ご主人様お目覚めですか……ふふっ、おはようございます。	어머나, 주인님 눈을 뜨고입니까……후후, 안녕하세요.
あっ、うん。おはよう。それで……なにをしているのかな？	아, 응. 안녕. 그래서……무엇을 하고 있는 것일까?
何って……ご主人様の逞しいおちんちんが立派になっていましたので、鎮めて差し上げようとしているのですが……	무엇은……주인님의 씩씩한 자지가 훌륭하게 되어 있었으므로, 진정시켜 드리려 하고 있습니다만……
そ、そうなんだ。あ、ありがとう？	, 그렇구나. 아, 고마워요?
はい♪　それではこのまま続けますね……。それにしてもご主人様のおちんちんは節操がないですね。私の手、もう先走り液でにゅるにゅるになってしまってます。	네♪　그러면 이대로 계속하네요……. 그렇다 치더라도 주인님의 자지는 절조가 없네요. 나의 손, 이제(벌써) 앞질러 해 액 나와 가 되어 버리고 있습니다.
いやぁ、昨日はちょっと欲求不満だったというか……そのまま寝ちゃったんだよね。	아니, 어제는 조금 욕구 불만이었다고 말할까……그대로 자버렸어군요.
もう、そういうことなら私を呼んでくださればいいのに……私ならいつでもご主人様のために頑張りますよ。	이제(벌써), 그런 것이라면 나를 불러 주시면 좋은데……나라면 언제라도 주인님을 위해서(때문에) 노력해요.
なんたって私たち相思相愛なんですから……このくらい当然ですよ。	아무튼 우리 상사상애이니까……이 정도 당연해요.
そう言って彼女は唇を俺の顔に近づけてくる。	그렇게 말해 그녀는 입술을 나의 얼굴에 접근해 온다.
んちゅ……ちゅ、ちゅぅ……ちゅる……ちゅっ、んんっ……ちゅっ……ちゅぅっ。	……, …………, 응응………….
んはぁ……ご主人様、とっても可愛い顔されてますよ。	응은……주인님, 매우 사랑스러운 얼굴 되고 있어요.
ふふっ、嬉しいことを言ってくださいますね。	후후, 기쁜 말을 해 주시네요.
彼女のペニスを握る手に力が入る。	그녀의 페니스를 잡는 손에 힘이 들어간다.
……ご主人様のペニスもビクビク震えて……ひょっとしてもうイキそうなのですか？	……주인님의 페니스도 벌벌 떨려……혹시 이제(벌써) 이키 그렇습니까?
うん、も、もう我慢できそうにない……かな？	응, 도, 이제(벌써) 참을 수 있을 것 같지 않은……일까?
なるほど、イッていいのですよ……全部私が受け止めて差し上げますから。	과연, 익이라고 좋은 것이에요……전부내가 받아 들여 드릴테니까.
そう言って彼女はこれ以上もない力で強くペニスを擦り上げてくれる。	그렇게 말해 그녀는 더 이상이나 없는 힘으로 강하게 페니스를 켜 준다.
……くっ！	……큭!
ひゃんっ！　あぁ……ご主人様の精液がこんなにたくさん……ふふっ、気持ちよかったですか？	응!　아……주인님의 정액이 이렇게 많이……후후, 기분 좋았습니까?
膣内射精と違い受け止めどころのない俺の精液が、暴れるように解き放たれ彼女の全身を穢す。	질내 사정과 달라 이해 어디가 없는 나의 정액이, 날뛰도록(듯이) 풀어 발해지고 그녀의 전신을 예.
はぁ、はぁ……凄く気持ちよかったよ。でもごめんね、精液、髪にまでかけちゃって……拭うの大変だよね？	후~, 후~……굉장히 기분 좋았어요. 그렇지만 미안해요, 정액, 머리카락에까지 걸쳐 버려서……닦는 것 대단하지?
いえ、お気遣いなく。これもご主人様の一部だと思うと愛おしくて、もっと、もっと欲しいと思ってしまいます。	아니요 신경써 없고. 이것도 주인님의 일부라고 생각하면(자) 사랑 아까워서, 좀 더, 좀 더 갖고 싶다고 생각해 버립니다.
そういって貰えると俺も助かるよ。	그렇게 말해 받을 수 있으면(자) 나도 살아나.
あの……ご主人様。その……ひとつお願いがあるのですが……	그……주인님. 그……하나 부탁이 있습니다만……
その、ご主人様のおちんちん擦っていると……それだけじゃ物足りなくなってしまいまして……その、ご主人様に慰めていただいて……よろしいでしょうか……？	그, 주인님의 자지 켜고 있으면(자)……그 만큼은 어딘지 부족하게 되어 버려서……그, 주인님에게 위로해주고……좋을까요……?
私のおまんこ……もう、ご主人様のおちんちん欲しくて、ぬるぬるになってきてしまっているんです……	나의 보지……이제(벌써), 주인님의 자지 갖고 싶어서, 미끈미끈이 되어 와 버리고 있습니다……
彼女の言葉を聞いて俺のペニスも硬さを取り戻す。	그녀의 말을 (들)물어 나의 페니스도 딱딱함을 되찾는다.
それじゃ、もう一回しようか。	그러면, 다시 한번 할까.
はい、ご主人様ありがとうございます……大好きです。いえ、愛しています……	네, 주인님 감사합니다……정말 좋아합니다. 아니요 사랑하고 있습니다……
他の子なんて見ずにずーっと、私だけを愛してくださいね。	다른 아이는 보지 않고 계속, 나만을 사랑해 주세요.
そうして彼女は昼過ぎるまで俺の上に跨り、精液が枯れるまで腰を振り続けてくれた。	그렇게 해서 그녀는 오후까지 나 위에 걸쳐, 정액이 시들 때까지 허리를 계속 거절해 주었다.
ん、ちゅる……ちゅ、ちゅっ……ちゅる……んふっ、ちゅる……ちゅるる……んちゅっ。	응, ……, …………, ………….
朝、心地よい温かさが股間を包み込む。	아침, 기분 좋은 따뜻함이 사타구니를 감싼다.
んちゅ、ちゅるる……れるっ、ちゅ、あっ、ごひゅひんさま……おふぁようございます……ちゅるる……んちゅ。	, ……, , 아, 히응님……있는………….
そう言って彼女は嬉しそうに微笑む。	그렇게 말해 그녀는 기쁜듯이 미소짓는다.
独占欲の強い彼女らしく、常に俺と一緒にいないと不安らしいのだ。	독점욕의 강한 그녀들 깐다, 항상 나와 함께 없으면 불안한 것 같은 것이다.
ちゅ……ちゅぶ、ちゅ、ごひゅじんさまの、おちんひん……きょうもがちがひですね、ちゅずっ……れるぅ、ちゅっ。	……, , 인님의, 떨어지지 않는 히응……오늘가 히군요, 두……,.
んふっ……ちゅっ、ふふっ……最近ご主人様の敏感なところが分かってきたんですよ。ご主人様はさきっちょを舐められるより、カリ首の方がお好きな様ですね。	……, 후후……최근 주인님의 민감한 곳이 알게 되었습니다. 주인님은 앞를 빨 수 있는 것보다, 칼리목이 좋아하는 같네요.
そう言って彼女のはカリ首に舌を這わせ舌先のざらっとした感覚を押し当てるようにペニスを舐め始めてくれる。	그렇게 말해 그녀의 것은 칼리목에 혀를 기게 한 혀끝의 자리등로 한 감각을 꽉 누르도록(듯이) 페니스를 빨아 시작해 준다.
うぉっ……おおっ、これは……	……, 이것은……
情けなくも一瞬ぴくっと腰が反応してしまう。	한심하지도 일순간 움찔 허리가 반응해 버린다.
んちゅぅ、ちゅちゅ……ふふっ、ご主人様、可愛いですよ。あぁ、私だけのご主人様……この時間が永遠に続けばいいのに……	, 츄츄……후후, 주인님, 사랑스러워요. 아, 나만의 주인님……이 시간이 영원히 계속되면 좋은데……
ちゅるる……んちゅ、そうですね、私ご主人様の精液ならいくらでも飲みたいれすから……お好きな時にだひてくださいね。	……, 그렇네요, 나주인님의 정액이라면 얼마든지 마시는 것 싶은 로부터……좋아하는 때에다 히라고 주세요.
彼女はそういうと、大胆に口内に俺のペニスを収めていく。	그녀는 그러한과 대담하게 입안에 나의 페니스를 거두어 간다.
んぢゅ……ずずっ、ちゅぶっ、ちゅちゅ……ちゅるる、ちゅっ……ちゅぅぅっ、ちゅんっ	……염주, , 츄츄……, ……, 응
寝ている時からの奉仕ですっかりと出来上がっていた俺のペニスはいつでも発射できる状態だった。	자고 있을 때로부터의 봉사로 완전히 완성되고 있던 나의 페니스는 언제라도 발사할 수 있는 상태였다.
そこを彼女の舌で蕩けるように愛撫され、俺の腰がビクビクと震える。	거기를 그녀의 혀로 녹도록(듯이) 애무되어 나의 허리가 벌벌떨린다.
ぢゅぶぶぶっ……ぢゅずっ、んちゅ、だひてっ、だひていいのですよっ……ごひゅんさまの精液はじぇんぶわらひのものなんれすからっ……ちゅぶぶっ、ちゅ！	……두, , 다 히라고 , 다 히라고 좋은 것이에요 ……응님의 정액은 짚히의 것 로부터 ……,!
んふぅぅぅぅぅぅぅぅぅぅっ！！　んぅ……んぅっ……んぐっ……んんっ。	!　응……응…………응응.
彼女の口の中で俺の精液がとめどなく溢れ出る。	그녀의 입 중(안)에서 나의 정액이와 목표 없게 넘쳐 나온다.
ぷはぁ……ふふっ、ご主人様精液……こんなにたくさん私にいただけるなんて、私はなんて幸せなメイドなのでしょう……。	후~……후후, 주인님 정액……이렇게 많이 나로부터 받을 수 있다니 나는은 행복한 메이드겠지요…….
ご主人様のお役に立てて私もとても嬉しいです。ふふっ、ご主人様、他にしてほしいことはございませんか？	주인님이 도움이 될 수 있어 나도 매우 기쁩니다. 후후, 주인님, 그 밖에 해 주었으면 하는 것은 없습니까?
私、ご主人様のためならどんなことでも致しますから、遠慮なさらずに仰ってくださいね。	나, 주인님을 위해서라면 어떤 일이라도 하기 때문에, 사양 하시지 않고 말씀하셔 주세요.
うん、ありがと。	응, 가와.
それじゃ、ご主人様……もう一度致しましょうか……あれ、本日はご主人様のおちんちん元気がないですね。	그러면, 주인님……한번 더 할까요……저것, 오늘은 주인님의 자지 기운이 없네요.
そうかな？	그런가?
そうですよ、いつもでしたらご主人様のモノはもうガチガチですのに……ひょっとして昨晩、私のいないところで他の誰かからご奉仕を受けましたか？	그래요, 언제나라면 주인님의 물건은 이제(벌써) 가치가치예요에……혹시 어젯밤, 나의 없는 곳으로 다른 누군가로부터 봉사를 받았습니까?
えっ！？　いやっ……そ、そんなことはないよっ。	어!　아니……, 그렇지 않아.
……ご主人様、他のメイドとエッチするのは構いませんが、私の事忘れないでくださいね。	……주인님, 다른 메이드와 섹스하는 것은 상관하지 않습니다만, 나의 일 잊지 말아 주세요.
う、うん……勿論だよ。	, 응……물론이야.
では私を愛し続けると約束してくださいますか？	그럼 나를 계속 사랑한다고 약속해 주십니까?
うん。	응.
それでは嘘ついたら針千本ですよ？　勿論飲むのは私ですけど。	그러면 거짓말 하면(자) 가시복이에요?　물론 마시는 것은 나이지만.
えっ、俺じゃないの？	어, 나가 아닌거야?
最愛の殿方にそのようなことさせらないですよ……ですから私との約束破らないでくださいね？	가장 사랑하는 남자분에게 그러한 일 시키고들 없어요……이기 때문에 나라는 약속 찢지 말아 주세요?
えっと……ご主人様……私は……	……주인님……저는……
ええ……ご主人様と二人きりになったら、私ぃ……もう我慢できないです、ご主人様を感じたくて……キスして頂けませんか、ご主人様……？	네…… 주인님과 단 둘이 되니, 저…… 이제 못 참겠어요, 주인님을 느끼고 싶어서…… 키스 해 주시지 않을래요, 주인님……?
はぅ、んちゅぅ……ちゅぷっ、愛してますご主人様、ご主人様ぁっ……！　んむぅ、ちゅ……ちゅぷぅ、もっと、もっとして下さいぃ……	하아…… 사랑해요 주인님, 주인님……!　……좀 더, 좀 더 해 주세요……
我慢できないんです、んちゅぅ……はしたない私を許して下さい、ご主人様ぁ、ちゅぷぅ、んんぅっ……キス、キスしたくてぇ……	못 참겠어요…… 버릇없는 저를 용서해 주세요, 주인님…… 키스, 키스하고 싶어서……
ちゅぷぅ、ご主人様の唇熱くてぇ、んむぅ……私、もう身体が疼いてしまいそうですぅ、私だけのご主人様ぁ、んぷぅ、ちゅっ……ちゅぷぅっ！	……주인님의 입술 뜨거워서 ……저, 이제 몸이 달아올라요, 나만의 주인님……!
あぁっ……ご主人様、ご主人様ご主人様ぁ……！　もっと、もっといやらしいキスしたいです……お願いです、あぁっ……	아앗……주인님, 주인님 주인님……!　좀 더, 좀 더 야한 키스 하고 싶어요…… 부탁해요, 아앗……
んむぅ、じゅぶぅ、じゅるるぅっ……！　お口の中にご主人様の舌、ちゅぷぅ、ちゅぅっ……熱くてぇ、んちゅぷぅ……ちゅるっ……	 …………입안에 주인님의 혀가 ……뜨거워서…………
んちゅ、美味しい、こくこく……ちゅぷぅ、ご主人様の唾液まで味わえるなんて、私ぃ……！　はぅ、ちゅっ……蕩けてしまいそうですぅ、ぢゅるるぅ……！	……맛있어………… 주인님의 침까지 맛볼 수 있다니 저……!　…………녹아 버릴 것 같아요……!
ふふっ、ねえ、ご主人様ぁ……れろぉ、ちゅぷぅ、んぢゅぅぅ……！　私、このまま……	후훗, 저기, 주인님……,, ……!　저, 이대로……
さすがご主人様、私が何も言わずとも、わかってくださるのですね……！　ですがその……ここでは、少し恥ずかしいです……	과연 주인님, 제가 아무것도 말하지 않아도, 알아 주시는 거네요……!　그치만 그…… 여기서는 조금 부끄러워요……
ご主人様が相手では、私、いくらでもはしたなくなってしまうんです……！　だから私の事、慰めて下さい、お願いですぅ……あぁ、ご主人様ご主人様ご主人様ぁっ……！	주인님이 상대라면 저, 얼마든지 부끄럽게 되어 버릴 거에요……!　그니까 저를, 위로해 주세요, 부탁해요 ……아아, 주인님 주인님 주인님……!
ふふっ……そのままでいて下さい、ご主人様ぁっ……	후훗……그대로 있어 주세요, 주인님……
私、もう我慢できないんです……ご主人様を前にしたら、抑えきれなくて……あぁ……愛しいご主人様……	저, 이제 못 참겠어요…… 주인님을 앞에 두면, 참을 수 없어서…… 아아…… 사랑스러운 주인님……
れろぉ、ちゅぷぅっ……ご主人様の、もうこんなに硬くなって……んむぅ……匂い嗅いでいるだけで、疼いてしまいそうです、んぢゅ、ちゅるるぅ……	……주인님의 거기, 벌써 이렇게 딱딱해져서………… 냄새 맡는 것 만으로도, 달아오를 것 같아요 ……
はい、だから余計にご主人様の匂い感じて、はぅ、んちゅぷぅ……私、胸が高鳴ってしまうんです、ちゅるるぅ……！　ご主人様の汚れ、私のお口で綺麗にしますからぁ……	네, 그니까 더 주인님의 냄새를 느껴서…… 저, 가슴이 쿵쾅대요……!　주인님의 더러운 건, 제 입으로 깨끗이 할테니까요……
んちゅぅ、ぢゅぶぅ……！　んむぅ、少しおしっこの味しますね、ご主人様ぁ……美味しいです、はぅ、ちゅりゅぅぅ……私の舌で、全部舐め取って、ちゅるるぅっ……	…………조금 오줌 맛이 나네요, 주인님…… 맛있어요………… 제 혀로, 전부 핥아서……
んむぅ、ぢゅっ……じゅぶぶぅ！　ご主人様の味、ご主人様の味、んちゅぷぅ！　わ、私幸せです、れろぉ、ちゅぅ……んぢゅぅうううっ！	…………　주인님의 맛, 주인님의 맛……!　……저, 저 행복해요………………!
ご主人様ご主人様ご主人様ぁ、れろぉ、じゅぷぅっ……！　私のお口、全部使いますから、んむぅ、ちゅるるぅ……なんでも言って下さいね……！	주인님 주인님 주인님……!　제 입, 전부 쓸테니까…… 뭐든지 말해 주세요……!
愛してます、ご主人様ぁ、はぅ、じゅぶぶぶぶぅ！　私のお口、ご主人様だけのモノですから、んちゅっ、ご主人様も私だけの……れろぉ、ちゅぷっ！　ちゅるるぅっ！	사랑해요, 주인니, 임!　……제 입, 주인님만의 것이니까…… 주인님도 나만의……!
じゅぷっ、んぅ、んじゅぷぅ！　先っぽから根本まで、じゅるるぅ、ご主人様の全て味わい尽くして、れろぉ、ちゅぷぅ、これだけで私、嬉しくて熱くなってしまいます……！	…………끝에서부터 뿌리까지…… 주인님을 전부 맛 보고…… 이것만으로도 저, 기뻐서 뜨거워져 버려요……!
んぷっ、イキそうなんですね、ご主人様ぁ……！　ふふっ！　れろぉ、ちゅぷっ、んぢゅぅうううっ！　精液下さい、ご主人様の精液、一滴残さず、余すところなく……んむぅ、私にぃっ！	……갈 것 같아요, 주인님……!　후훗!　…………정액 주세요, 주인님의 정액, 한 방울도 남기지 말고 남김없이…… 저에게!
んぢゅぅぅぅぅぅ……！　んんぅ、わたくひの、はぅっ……おくひのなか、ごひゅじんひゃまのがたくさん、んぅっ……！	………… 제 ……안쪽에…… 주인니메 것이 잔뜩……!
こくこく、んぅっ……あぁ、美味しいです、ご主人様ぁ……精液こんなに出してくれて、んくっ……私、これだけで蕩けてしまいそうです、はぅうっ……	…………아아, 맛있어요, 주인님…… 정액 이렇게 싸주시고…… 저, 이것만으로도 녹아 버릴 것 같아요……
ふふっ……まだまだ出ますよね、ご主人様ぁ……？　もっともっと……もっともっともっともっと、ご主人様の精液味わわせて下さいね……？	후훗……아직도 나오네요, 주인님……?　좀더 좀더……좀더 좀더 좀더 좀더, 주인님의 정액을 맛보게 해 주세요……?
思わず我慢できずに、お口でご奉仕してしまいましたが……続きはお部屋でしますから、ふふっ……私の身体、どこでもお好きなように使って下さい、ご主人様……	저도 모르게 못 참아서, 입으로 봉사해 버렸지만요…… 다음은 방에서 할테니까, 후훗…… 제 몸, 어디든지 마음대로 써 주세요, 주인님……
その淫靡な笑顔に、俺は打ち抜かれてしまうのであった。	그 음란한 미소에, 나는 함락되는 것이었다.
お願いです、ご主人様ぁ……もう我慢できないんです、キス……キスして下さい、あぁっ……	부탁이에요, 주인님…… 이제 못 참겠어요, 키스…… 키스 해 주세요, 아앗……
ご主人様の唇、んぅ……熱くて、はぁ、私ぃ……ちゅ、ちゅぷぅっ……胸が高鳴ってしまいますぅ、あぁ、ご主人様ご主人様ぁ、愛してます、んちゅぅ……	주인님의 입술…… 뜨거워서, 하아, 저………… 가슴이 두근거려서, 아아, 주인님 주인님, 사랑해요……
んむぅ、私ぃ……ちゅぷぅ、ご主人様さえいれば、他には何もいらないですから、はぅ、ちゅ、んちゅぅ……	……저…… 주인님만 있으면, 다른 건 아무것도 필요없으니까요…………
あぁぁっ……！　ご主人様ぁ、はぅっ……私、私ぃっ……！	………… 주인님…… 저, 저……!
夜伽に誘って頂いた時から、胸が高鳴って……もう我慢できそうにありません、ご主人様とこんなに近くにいるのだから……うぅ、一秒でも早く、ご主人様を感じたいんですぅ……	밤시중에 불렸을 때부터, 가슴이 두근거려서…… 이제 못 참겠어요, 주인님이랑 이렇게 가까이 있으니까…… 1초라도 빨리, 주인님을 느끼고 싶어요……
ご主人様に愛して頂きたいんです……んっ……あ、あの……もう、濡れちゃって、準備できてますから……	주인님에게 사랑받고 싶어요…………저, 저기…… 이제 젖어 버려서, 준비하고 있으니까요……
セックスしてほしいです、ご主人様の逞しいモノで私の中掻き回して、ぐちゅぐちゅにしてぇ……ご主人様の事以外感じられなくしてほしいんです、あぁっ……	섹스하고 싶어요, 주인님의 씩씩한 물건으로 제 안을 휘저어서, 질척질척 하고 싶어…… 주인님의 거기가 아니면 느끼지 못하게 되고 싶어요……
私の身体はご主人様だけのモノですから……あぁ、太くて硬くなってるご主人様の突き入れて、奥までご主人様の形にしてほしいんです……！	제 몸은 주인님만의 것이니까요…… 아아, 굵고 딱딱해진 주인님의 거기를 쑤셔 넣어서, 안쪽까지 주인님의 모양으로 만들고 싶어요……!
ご主人様に挿れてもらえないなら、私、私ぃ……！　あぁっ……きっとこのまま駄目になってしまいます、うぅ……お願いです、ご主人様ご主人様ご主人様ぁっ……！	주인님이 넣어 주지 않으면, 저, 저……!　아앗……분명 이대로 망가져 버릴 거에요, ……부탁이에요, 주인님 주인님 주인님……!
んくぅうううっ……！　はぁはぁ、奥まで届いて、あぁん！　嬉しいですご主人様ぁ！　んんぅ、ぐちゅぐちゅはしたない音響いて、あっあっ、ご主人様ぁっ……！	…………하아하아, 안쪽까지 닿아서, 아앗!　기뻐요 주인님!　……질척질척 부끄러운 소리 내고…… 주인니임……!
ご主人様に奉仕できるって考えたら、んくぅ、私それだけでぇ……！　はぁはぁ、身体疼いてしまうんです、あっあっ、ひゃぁん！	주인님에게 봉사할 수 있고 생각하니…… 저 그것만으로도……!　하아하아, 몸이 달아 올라요…………!
だって私、んんぅ、いつもずっと毎日どんな時もっ……ご主人様の事考えていますから、あっ、んくっ！　本当は片時も離れたくないくらい……だから、キスしたらすぐに濡れて……！	왜냐면 저…… 항상 계속 매일 언제나…… 주인님을 생각하고 있으니까요, 앗……!　잠시도 떨어지고 싶지 않을 정도로…… 그니까, 키스 하자 마자 젖어서……!
あぁ、私ははしたないメイドです、ご主人様ぁ……キスしただけで発情するような、床を汚してしまうくらい、濡れてしまうような……！　んんぅ、はぅううっ！	아아, 저는 버릇없는 메이드에요, 주인님…… 키스한 것만으로도 발정하는, 바닥를 더럽힐 정도로 젖어 버리는………………!
だって私、んんぅ、ご主人様を感じられるだけでぇ、ぁああああっ！　幸せですから、はぁはぁっ、いつまでもこうしていたいんです、あっ、んくぅっ……！	왜냐면 저…… 주인님을 느끼는 것만으로도, 아아아아앗!　행복하니까요, 하아하앗, 언제까지나 이렇게 있고 싶어요, 앗…………!
ご主人様ご主人様ご主人様ぁっ！　あぁ、んくぅん！　こ、こんなに激しくしてくださるなんてぇ、んんぅ！　わ、私、嬉しくて、はぁはぁ、たくさん締め付けてしまいます……！	주인님 주인님 주인님!　아아……!　이, 이렇게 격렬하게 해 주시다니……!　저, 저, 기뻐서, 하아하아, 잔뜩 조여 버려요……!
いつまでこうしていたいです、あっあっ、んひぃん！　私の中、ぐりぐりされて、一番奥、ご主人様のでキスされて……！　もっともっと、感じさせて下さい、んぅ、はぅうん！	언제까지나 이렇게 있고 싶어요…………!　제 안쪽, 둥글둥글해져서, 가장 안쪽, 주인님의 거기에 키스 받아서……!　좀더 좀더, 느끼게 해 주세요…………!
私だけの、私だけのご主人様ぁ、んくぅ、ひゃぁん！　幸せ過ぎて、私ぃ……んんぅ、蕩けてしまいそう……！	나만의, 나만의 주인님…………!　너무 행복해서, 나…… 녹을 거 같아……!
わ、わかりました、んんぅ、あぁん……！　続きはお部屋でぇ！　はぁはぁ、一晩中、ご主人様にご奉仕できるのですね……？　ふふっ、嬉しいですぅ、ぁああああっ！	아, 알겠어요…………!　다음은 방에서!　하아하아, 밤새, 주인님에게 봉사할 수 있는 거네요……?　후훗, 기뻐요, 아아아아앗!
んぅううううううっ！　ご主人様、ご主人様ぁっ！！	………………주인님, 주인니임!
んぅ、中に出したのですね、ご主人様ぁ……ふふっ、ふふふっ……！　あぁ、なんて幸せなんでしょうか、はぅうっ……溢れそうなくらいの、ご主人様の精液ぃ……	……안에다 싸셨네요, 주인님…… 후훗, 후후훗……!　아아, 어쩜 이렇게 행복할까요 ……흘러넘칠 정도로, 주인님의 정액……
私を躾けたのはご主人様のなのですから、んぅっ……だからこれからも責任を取って、たくさん愛して下さいね？　いつまでも、いつまでも……ふふっ……	저를 길들인 건 주인님이니까요…… 그니까 앞으로도 책임 지고 많이 사랑해 주세요?　언제까지나, 언제까지나…… 후훗……
あ、あの……ご主人様、よろしいでしょうか……	저, 저기…… 주인님, 괜찮을까요……
お願いがあるのですが……私の事を、今ここで苛めて頂けませんか……？	부탁이 있는데요…… 저를, 지금 여기서 괴롭혀 주시지 않을래요……?
も、申し訳ありません……ご主人様とお話ししている時から、その……私、一秒でも早く苛めてほしいって、思ってしまっていたんです……！	죄, 죄송해요…… 주인님이랑 이야기하고 있을 때부터, 그…… 저, 1초라도 빨리 괴롭혀줬으면 좋겠다고, 생각하고 있었어요……!
はしたないメイドに、ご主人様……んぅ、イラマチオ、してほしいんです……	버릇없는 메이드에게, 주인님…… 이라마치오, 해주시면 좋겠어요……
ぐぷっ……！　んぐ、ぉごぉ……ごひゅじんひゃまの、おおきいです、んんぅっ……	…………주인니메 거기, 커요……
もうしわけありません、んんぅ、ぉごっ……わ、わたくひ、んむぅっ……いじめられるのがすきな、へんたいメイドでぇ、うぐぅっ……	죄송해요…… 저, 저…… 괴롭혀 지는 걸 좋아하는, 변태 메이드라서……
ごひゅじんひゃま、んぷっ、うぐぅ……このまま、わたくひのこと、んんぅっ……おしおきして、ほしいんですぅ、ぁああっ……んぐぷぅっ……	주인님………… 이대로, 저를………… 벌 해 주시면, 좋겠어요, 아아앗…………
んぐぅ、うっ！？　ぐぷうっ……んっ、ひゅぐっ！　ご、ごひゅじんひゃまぁ、んむぅ、もっと、おくまでぇ……！	…………주인님…… 좀 더 안쪽까지이……!
ぷはぁっ……んぅ、ご、ご主人様にされるなら私、ぁああっ……喉奥を……犯されると、胸が高鳴ってしまうんですぅ、あぁ、ご主人様ぁっ……	………… 주인님에게 당하면 저, 아아앗…… 목 안을…… 범해지면, 가슴이 두근거려요, 아아, 주인님……
それに……ご主人様が、私で興奮してこんなに大きくしてくれているだなんて……そう考えるだけで私、ご主人様には何をされても良くなってしまいそうです……	그리고…… 주인님이 저로 흥분해서 이렇게 크게 해 주시다니…… 그렇게 생각하니 저, 주인님에게는 뭘 당해도 좋을 것 같아요……
んぐぅぅぅううっ！　んぷっ、ごひゅじんひゃま、んんっ、ぉごおっ！　わ、わたくひ、んぷっ、うれしくて、うぐぅぅっ……！	…………주인니임…………　저, 저 기뻐서……!
ごひゅじんひゃま、ごひゅじんひゃまぁ！　んぐぷぅ、んんんぅっ！　いんらんメイドだなんてぇ、んんっ！　よ、よけいにこうふんしてしまいます、んむぅ、ぉごおっ！	주인님, 주인님!…………　음란 메이드라니……!　더 흥분해 버려요…………!
おくひのおく、んむぅ、ほしいんです、ぐぷぅっ！　んんっ、ごひゅじんひゃまの、あつくてこいのが……！　んぐぢゅっ、おねがいですぅ、ごひゅじんひゃまぁっ	제 안에……주세요!　…………주인니메 뜨겁고 진한 걸……!　 부탁드려요, 주인님
んぶぅぅうううっ……！？　んんっ、うぅっ……ぷはっ、ごほごほっ……んっ、けほっ……	……………후앗…………아핫……
んっ、こくこくっ……はぁ、んくっ……ふふっ、ご主人様の濃くてぇ、んんぅ……身体の中まで、熱くなってしまいます、はぅっ……	…………하아…… 후훗, 주인님 거 진해서…… 몸 속까지 뜨거워지네요……
あぁ、ご主人様、ご主人様ぁ……こんなはしたない、淫乱メイドの私にぃ……たくさんの精液注ぎ込んでくださって、ありがとうございます、ご主人様ぁ……	아아, 주인님 주인님…… 이렇게 버릇없는, 음란 메이드인 저에게…… 많은 정액을 싸 주셔서, 감사합니다, 주인니임……
も、もっとご主人様に、お仕置きして頂けるんですね……！　私、幸せですご主人様……！　たくさん苛めてもらえるって思うだけで、私……はぁあんっ……	조, 좀 더 주인님에게 벌 받을 수 있는 거네요……!　저, 행복해요 주인님……!　잔뜩 괴롭혀진다고 생각하는 것만으로도, 저…………
申し訳ありません、私我慢できなくて、あぁっ……ここで、この場でご主人様にして頂きたいんです、はぅうっ……	죄송해요, 저 못 참겠어서, 아앗…… 여기서, 이 자리에서 주인님이랑 하고 싶어요……
ええ、ご主人様……ふふっ、私、痛いのが好きなんです、ご主人様に痛くしてほしいんです……！	네, 주인님…… 후훗, 저, 아픈 걸 좋아해요, 주인님이 아프게 해주세요……!
で、できれば今すぐにでもして頂けると嬉しいです、ご主人様ぁ……このままだと濡れてしまいますから……あぁ、早く、挿れてほしくてぇ……	하, 할 수 있으면 지금 당장이라도 해 주신다면 기뻐요, 주인님…… 이대로라면 젖어 버리니까요…… 아아, 빨리, 넣고 싶어……
んぐぅうううっ……！　あぁ、んんっ、苦しいから、はぁっ……私、身体が熱くなってぇ、ぁああああっ……！	………………아아…… 괴로워서, 하앗…… 저, 몸이 뜨거워져서, 아아아아앗……!
んぐぅ、あぁっ……す、すごいですご主人様ぁ、ぁあああっ……中、痛くされると、うくっ、はぁああっ……んんぅ、たくさん締め付けてぇ……	……아앗…… 대, 대단해요 주인님, 아아아앗…… 안 쪽을 아프게 하면…… 하아아앗…… 꽉 조이고 싶어……
ふふっ……んくっ、ご主人様……私のお尻、その……ご主人様に叩いて頂ければ、はぁ、はぁっ……もっときつく、締め付けられますよ……	후훗…… 주인님…… 제 엉덩이, 그…… 주인님이 때려주시면, 하아, 하앗…… 좀 더 힘줘서, 꽉 조일 수 있어요……
だからご主人様、ふふふっ……遠慮などいりませんから、はぁ、んくぅっ……たくさん叩いて下さい、ご主人様ぁっ……	그니까 주인님, 후후훗……사양하지 않아도 되니까요, 하아…… 잔뜩 때려 주세요, 주인니임……
はぅううっ……んひぃいいん！　あぁ、熱くて、んんっ……お尻ジンジンして気持ち良いです、あぁっ……ご主人様に叩かれて、私ぃっ……！	………………아아, 뜨거워서…… 엉덩이 얼얼해서 기분 좋아요, 아앗…… 주인님에게 맞아서, 저……!
いかがですかご主人様、はぁ、んんぅっ……わ、私の中、あぅん……ちゃんと締まりましたか、あぁ、はぅううっ……	어땠어요 주인님, 하아…… 제, 제 안쪽…… 제대로 꽉 조였나요, 아아…………
ぁあああっ、ご主人様、ひゃぁん！　あぁっ、んくぅ……激しくて、私ぃ！　はしたない声抑えられません、はぁっ、あぅううっ……！	아아아앗, 주인님,!　아앗…… 격렬해서, 저!　부끄러운 소리 못 참겠어요, 하앗……!
は、はい、仰る通りです、んくぅ……！　ご主人様にお尻叩かれてるから、ぁあああっ！　いやらしいお汁たくさん垂れてぇ、はしたない音立ててるんですぅ……！	네, 네, 말하신 대로에요……!　주인님에게 엉덩이 맞아서, 아아아앗!　부끄러운 즙이 잔뜩 늘어져서, 야한 소리 내고 있어요……!
はぅううっ、ひぃいん！　叩かれると熱くなってぇ、私のお尻ぃ！　んんっ、疼いてきてしまうんです、ご、ご主人様、もっと、んぅううううっ……	………………맞으면 뜨거워져서, 제 엉덩이!　……달아올라 버려요…… 주인님, 좀 더………………
はぁあっ、んぐぅぅうっ！　あっあっ、んぅっ……お部屋じゃないのに、私ぃ、んんっ！　あ、頭真っ白になってしまいそうですぅ、あっ、んくぅん！	하아앗…………………… 방이 아닌데도, 저……!　머, 머릿속 하얗게 될 것 같아요, 앗……!
も、申し訳ありません、んひぃいいん！？　あぁっ、ご主人様にお手間をお掛けして、はぁはぁ、ぁあああっ、ひゃぁん！	죄, 죄송해요…………!　아앗, 주인님을 귀찮게 해서, 하아하아, 아아아앗……!
で、ですけど、はぁはぁ、くぅん……！　お願いです、ご主人様ぁ！　あっあっ、私の事、んくぅ、最後まで苛めて、あぁっ……イかせてほしいんですぅっ！	그, 그치만, 하아하아……!　부탁이에요, 주인님!　저를…… 끝까지 괴롭혀서, 아앗…… 가버리고 싶어요!
ありがとうございますぅ、んぐぅうっ！　はぁああっ、んぅっ……嬉しいです、ご主人様ぁ、はぁはぁっ、痛いの大好きだからぁ、もう蕩けてぇ、ぁああああっ……！	감사합니다……!　하아아앗…… 기뻐요, 주인님, 하아하앗, 아픈 거 정말 좋아하니까요, 벌써 녹겠어요, 아아아아앗……!
んぅうううっ、ご主人様ぁ、な、中熱いですぅ、ぁあああああああああっ！！	…………주인님, 아, 안 쪽이 뜨거워요, 아아아아아아아아아앗!
ジンジンして、あぁ、はぅううっ……や、火傷しそうです、私ぃ……んぅ、ご主人様に痛くされて、蕩けてしまいました、はぅっ……	얼얼해서, 아아………… 저, 화상입을 것 같아요, 저…… 주인님에게 아픈 걸 당해서, 녹아 버렸어요……
私の中に、溢れそうなくらい出してくれるなんて、ご主人様ぁ……はしたない変態メイドに、んぅっ……ありがとうございます、あっ、はぁあっ……	제 안에, 흘러넘칠 정도로 싸 주시다니, 주인님…… 버릇없는 변태 메이드에게…… 감사합니다, 앗, 하아앗……
ふふっ、嬉しいです……！　私がご主人様の特別だなんてぇ……！　あぁ、そんな事言われてしまったら、私ぃ……また疼いてしまいますから……！	후훗, 기뻐요……!　제가 주인님에게 특별하다니……!　아아, 그런 말을 들으면, 저…… 또 달아 오르겠어요……!
もっともっと、ご主人様……私の事苛めて下さい、虐げて下さい、辱めて下さいぃ、あぁっ……たくさん痛くして、何度でも……ふふふっ……！	좀 더 좀 더, 주인님…… 저를 괴롭혀 주세요, 학대해 주세요, 능욕해 주세요, 아앗…… 잔뜩 아프게 해서, 몇 번이라도…… 후후훗……!
んぅっ……あぁ、わ、私ぃ……なんだかあたまがぼうっとしてしまって、はぁ、あぅっ……	……아아…… 저, 저…… 뭔가 머리가 어지러워서, 하아……
おねがいがあるのですが、ごしゅじんさまぁ……んぅ、そ、その、私のからだに、ふれてほしいのです……	부탁이 있는데요, 주인니임…… 그, 제 몸을, 만져 주세요……
で、ですけど……ずっとはしたないことをかんがえていて、私ぃ……このままでは、たえられないんですぅ……	그, 그치만…… 계속 부끄러운 걸 생각하고 있어서, 저…… 이대로는 못 참겠어요……
じ、じぶんで、ですか……？　うぅっ……けれど、ごしゅじんさま……い、いいんですか、じぶんでしてしまって……	스, 스스로 인가요……?　……그치만, 주인님…… 괘, 괜찮을까요, 혼자서 해버려도……
んぅ……で、ですよね……はぁ、あぅうっ……ふれていただけないのさびしいですけど、あぁっ……わ、私、もう我慢できません……！	……그, 그러네요……하아…… 만져 주시지 않는 건 외롭지만, 아앗…… 저, 저, 이제 못 참겠어요……!
ふふっ……んぅ、見て下さい、あぁっ……触れてもいないのに、濡れてきてしまいました……はぁ、はぁっ……いやらしいですね、んんぅ……	후훗…… 보세요, 아앗…… 만지지도 않았는데, 젖어 버렸어요…… 하아, 하앗…… 음란하네요……
おっしゃるとおり、です、んぅっ……お酒を飲んでいる時から、はぅうっ……熱くなって、こんな風になってしまっていたんですぅ……	말하신 대로, 에요…… 술 마시고 있을 때부터…… 뜨거워져서, 이렇게 되어 있었어요 ……
お酒を飲み終わってから、あぁっ……ご主人様にされてしまうって想像しただけで、はぁ、はぁっ……いやらしいお汁がっ……	술을 마시고 나서, 아앗…… 주인님이랑 한다고 상상했을 뿐인데, 하아, 하앗…… 야한 즙이 ……
ええ、そうです……んぅ、ご主人様に、その……どのような事をして頂けるのかって、あぁっ……ずっと考えていましたぁ……	네, 그래요…… 주인님이, 그……어떤 걸 해 주실지, 아앗……계속 생각하고 있었어요……
は、はい、そうですぅ……！　私ぃ、もっと激しくオナニーしたいんです……！　くちゅくちゅって弄って、アソコ擦ってぇ……あぁ、はぅううっ……	네, 네, 맞아요 ……!　저, 좀 더 격렬하게 자위하고 싶어요……!　질척질척하게 비틀고 거길 비벼서……아아……
あぁ、嬉しいです、ご主人様ぁ……！　ありがとうございます、んぅ、はぅうっ……それじゃご主人様、んぅ、私、しますね……	아아, 기뻐요, 주인님……!　감사합니다…… 그럼 주인님…… 저, 할게요……
あっあっ、はぅううっ！　んぅ、イキたいです、ご主人様ぁ……！　私、ご主人様の見ている前で思いきり、んんぅ、イってしまいたいんですぅ……！	……………… 가고 싶어요, 주인님……!　저, 주인님이 보는 앞에서 마음껏………… 가버리고 싶어요……!
んんぅ！　はぁはぁっ、身体熱くなってぇ、あっ、くぅん……！　クリトリス弄ってるから、あぁっ……いやらしい声たくさん出てぇ、はぅううん！	……하아하앗, 몸이 뜨거워져서, 앗……!　클리토리스 괴롭히니까, 아앗…… 야한 소리 잔뜩 나와서……!
あっあっ……はしたないですけど、んぅ、ご主人様にされたいって考えながら私、あぁん！　敏感なところ摘まんで、擦って、弄ってぇ……！	……부끄럽지만요…… 주인님이랑 하고 싶다고 생각하니 저, 아앗!　민감한 곳 비틀고 비비고 주물러서……!
あっあっ、ご主人様、ご主人様ご主人様ぁっ！　んぅ、か、身体疼いて、イキます、私イキますぅぅっ！　んぅううっ、あぁん！	…… 주인님, 주인님 주인님!　……모, 몸이 달아올라서, 가요, 저 가버려요!　……아앗!
ぁあああっ……！　わ、私、私ぃ！　イクイクっ、イキますぅぅぅぅぅぅぅぅぅ！！	아아아앗……!　저, 저, 저!　가 가, 가버려어어어어어어어어어!
はぁっ、ぁああああっ……！　オナニーすごいですぅ、あぁっ……ご主人様の前で、こんなにはしたなく蕩けてぇ、んぅっ……	하앗, 아아아아앗 ……!　자위 대단해요, 아앗……주인님 앞에서, 이렇게 부끄럽게 녹아서……
頭真っ白になったからぁ、はうっ……な、何も考えられないです、あぁっ、ご主人様ぁっ……	머리속이 하얗게 되어서………… 아무 생각도 못 하겠어요, 아앗, 주인님……
あぁ、ふふふっ……そうでしたね、ご主人様……んぅ、オナニーだけじゃなくて、はぅ……これから、ご主人様にたくさん気持ち良くしてもらえるんでしたね……	아아, 후후훗……그랬네요, 주인님…… 자위뿐만이 아니고, 지 ……지금부터, 주인님에게 잔뜩 기분 좋아질 수 있겠네요……
私ぃ、んぅっ……何をされても感じて、ぐちゅぐちゅになってしまいそうですぅ……あぁ、はぅうっ……気持ち良いの抑えられなくて、あぁっ……！	저…… 뭘 하셔도 느껴서 질척질척하게 될 것 같아요 ……아아…… 기분 좋은 걸 못 참겠어서, 아앗……!
も、申し訳ありませんが、ご主人様……んぅ、その、お部屋の方には……さ、先に行って頂いていいでしょうか……？	죄, 죄송한데요, 주인님…… 그, 방에는…… 머, 먼저 가 주실 수 있을까요……?
私……お酒をたくさん飲んでしまいましたから……少し、あの……	저……술을 많이 마셔서……조금, 그……
そ、そうです……ですので、お手洗いに行かせてほしいのですが……	마, 맞아요……그래서, 화장실에 가고 싶은데요……
こ、この場でですかっ……？　そのようなはしたない事、ううっ……	여, 여기서요……?　그런 부끄러운 걸……
ご主人様、んぅっ……ええ、承知……しました……んっ……くぅんっ……	주인님…… 알겠……어요………………
はしたないですけど、んんぅ……ここでします、から……はぁ、あぅうっ……その、だれかこないか、ご主人様……見ていて下さい、んぅっ……	부끄럽지만……여기서 할, 게요…… 하아……그, 누가 오지는 않는지, 주인님……보고 있어 주세요……
い、意地悪を言わないでください、はぅうっ……そのようなことを言われては、あぁ、んんぅ……おしっこ、するの恥ずかしくてぇ……	시, 심술궂게 말하지 말아 주세요…… 그런 말을 들으면, 아아……오줌, 누는 거 부끄러워서 ……
あまり、んぅっ……じろじろ見られてしまうと、私ぃ……うぅ、耐えられなくなってしまいます……	너무…… 빤히 쳐다보면, 저…… 못 참겠어요……
だ、大丈夫ですから、んんぅ……私ひとりでできますから、ご主人様ぁ、いたずらはしないでください、あぁっ、んっ……	괘, 괜찮으니까요…… 저 혼자서 할 수 있으니까요, 주인님, 장난치지 말아 주세요, 아앗……
んぅ、ぁあああっ……！　そ、そろそろ、んんぅ……おしっこ出そうです、あぁ、ご主人様ぁっ……！	……아아아앗……!　스, 슬슬……오줌 나오겠어요, 아아, 주인님……!
ぁああああああっ……！　ご、ご主人様の前で、私ぃ……んぅ、あぁん……	아아아아아아앗 ……!　주, 주인님 앞에서, 저…… 아앗……
ぜ、全部出ました、あぁ、はぅううっ……いかがですか、ご主人様、んんぅ……私の、おしっこするところは……	저, 전부 나왔어요, 아아…… 어땠어요, 주인님……제, 오줌 누는 곳은……
うぅ、申し訳ありません、ご主人様……そ、その……私の事、おしおきするのでしょうか……？	……죄송해요, 주인님…… 그, 그……저를, 벌 주는 건가요……?
あぁ、ご主人様ぁ……私、はしたないメイドですからぁ……おしっこ漏らした私のこと……きちんと……調教して、くださいね……？	아아, 주인님……저, 버릇없는 메이드니까…… 오줌 흘린 저를……제대로……조교해, 주세요……?
ふふっ、ふふふっ……！　ご主人様ぁ……あぁ、私、これからご主人様にぃ、たくさん愛してもらえるのですね……？	후훗, 후후훗……!　주인님…… 아아, 저, 지금부터 주인님에게, 잔뜩 사랑받는 거네요……?
大胆、ですか……？　私はただ……んぅ、私の全てを、ご主人様に愛して頂きたいだけですよ、ふふっ……	대담, 한가요……?　저는 그냥…… 저의 모든 것을, 주인님에게 사랑받고 싶은 것뿐이에요, 후훗……
あの、ご主人様ぁ……ふふっ……その、お部屋に行く前に……んぅ、ここで、して頂けませんかぁ……？	저, 주인님……후훗……그, 방에 가기 전에…… 여기서, 해 주시지 않을래요……?
私、待ちきれないんですぅ……！　だってぇ、あぁっ……何より大切なご主人様が、今目の前にいるんですもの……一秒でも早く、ご主人様を感じたくてぇ……	저, 못 기다리겠어요……!　왜냐면, 아앗…… 제일 소중한 주인님이, 지금 눈앞에 있는 걸요……1초라도 빨리, 주인님을 느끼고 싶어서 ……
あぁ、ご主人様ぁっ……！　んぅ、私、胸が高鳴って、はぁあっ……たくさん触って下さい、んんぅっ……	아아, 주인님……!　……저, 가슴이 두근거려서, 하아앗…… 잔뜩 만져 주세요……
欲しいです、ご主人様の……！　ふふっ、ですが……今は、こうして触れられているだけで、蕩けてしまいそうなくらい、熱くなってしまってぇ……	원해요, 주인님을……!　후훗, 그치만……지금은, 이렇게 닿을 수 있는 것만으로도, 녹을 것 처럼 뜨거워져 버려서 ……
ここでは、んぅ……発情している、私のはしたないアソコ……苛めて下さい、はぁ、はぁっ……お部屋では、その後たくさんしてほしいから……	여기서는…… 발정하고 있는, 제 부끄러운 거기……괴롭혀 주세요, 하아, 하앗…… 방에서는, 그 뒤에 잔뜩 하고 싶으니까……
ご主人様となら私ぃ、いつでも、いつまでも……明日も明後日もずっとずっと、していたいですからぁ……満足するなんて、そんな事ありません……	주인님과 함께라면 저, 언제라도, 언제까지라도……내일도 모레도 계속 계속, 하고 싶으니까요…… 만족하다니, 그런 일은 없어요……
んぅううう、ご主人様ぁ！　はぁはぁ、はしたない音鳴って、あぁっ……！　指良いですぅ、あっあっ、はぅううっ……	…………주인님!　하아하아, 부끄러운 소리 나와, 아앗……!　손가락 좋아요…………
くちゅくちゅって、んんぅ！　弄られる度に鳴ってますぅ……！　ご主人様の指で愛してもらえるなんて、私、私ぃ！　あっあっ、はぅうううっ！	질척질척하고……!　만질 때마다 소리가 나요 ……!　주인님의 손가락으로 사랑받을 수 있다니 저, 저…………!
あっ、んひぃいいいいん……！　そ、そこ良いです、ご主人様ぁ……もっとそこ責めて下さい、んんっ、ひゃぁん！？	……………… 거기 좋아요, 주인님……좀 더 거길 꾸짖어 주세요……!
も、もう抑えられないですぅ！　あっあっ、ご主人様ぁ、んんぅ、ご主人様ぁ……！　頭真っ白になりそうでぇ、こんなに弄られたら、はぁ、はぁあああっ……！	이, 이제 못 참겠어요!　……주인님…… 주인님……!　머릿속이 하얗게 될 거 같아, 이렇게 만지면, 하아, 하아아아앗……!
あ、ありがとうございます、んぅうううっ！　はぁはぁ、ご主人様にそんな風に言ってもらえたら私、それだけで、それだけでぇっ！	가, 감사합니다…………!　하아하아, 주인님이 그런 식으로 말해 주면 저, 그것만으로도, 그것만으로도!
ぁああああああああっ、ご主人様ぁ！　はぁああっ、んぅううっ……！！	아아아아아아아아앗, 주인님!　하아아앗……!
あぁ、くぅん……ふふっ、私ぃ、ふふふっ……ご主人様にイかされたのですね、はぁあっ……頭、ぼうっとしてぇ……あぁ、幸せです、んんぅっ……	아아……후훗, 저, 후후훗……주인님으로 가버렸네요, 하아앗……머리가, 멍해서 ……아, 행복해요……
私もご主人様が好きです、大好きです、愛してますぅ、あぁっ……！　もっともっと、私、ご主人様と愛し合いたくて……しょうがなくなってっ……	저도 주인님을 좋아해요, 너무 좋아해요, 사랑해요, 아앗……!　좀 더 좀 더, 저, 주인님이랑 서로 사랑하고 싶어서…… 어쩔 수 없어……
早くお部屋に行きましょう、ご主人様ぁ……私、なんでもいたしますから、ふふっ……朝まででも、いつまでも……お相手いたしますからぁ、ご主人様、ご主人様ぁ……！	빨리 방에 가요, 주인님……저, 뭐든지 해 드릴게요, 후훗……아침까지라도, 언제까지나…… 상대 해 드릴테니까요, 주인님, 주인님……!
ご主人様……私、見ていたのですけど……先ほどお喋りしている時に、他のメイドを見ていましたよね……私が目の前にいるというのに、ご主人様は他のメイドを……	주인님……저, 보고 있었는데요…… 아까 이야기하고 있을 때, 다른 메이드를 보고 있었죠…… 제가 눈앞에 있는데도, 주인님은 다른 메이드를……
ちょ、ちょっと気になって……？　私が……恋人である私が居るのに……そのメイドというのは、一体どこの方でしょうか……私のご主人様をたぶらかすだなんて、許せない……	조, 조금 신경 쓰이네……?　내가…… 연인인 내가 있는데…… 그 메이드라는 년은, 도대체 어디에 있죠…… 내 주인님을 속이다니, 용서할 수 없어……
何より大切な私のご主人様が、んぅ……他のメイドに目を奪われるなんて、あるまじきことです……ご主人様は、私の事が大切ではないのですか……？	제일 소중한 제 주인님이…… 다른 메이드에게 눈을 돌리다니, 있을 수 없는 일이네요…… 주인님은, 제가 소중하지 않나요……?
お部屋に行く前に……私がご主人様のモノであり、ご主人様が私のモノである事を……んんっ、ちゃんと教えて差し上げますからぁ……	방에 가기 전에…… 제가 주인님의 것이고, 주인님이 제 것이라는 걸…… 확실하게 가르쳐 드릴테니까요……
れるぅ、ちゅっ……ちゅるるぅ……私のお口でぇ、んちゅぅっ……他のメイドの事など、忘れさせます、れろぉ、ぢゅぷぅっ……	…………제 입으로…… 다른 메이드는, 잊게 할게요……
ご主人様ご主人様、ご主人様ぁ……ちゅぷぅ、んちゅっ……はぅ、ちゅるるるぅ……！　私の事だけ、私の事だけ考えていて下さい、んちゅぷぅ……	주인님 주인님, 주인님………………!　저만, 저만 생각하세요……
それならご主人様、ちゅっ、ちゅぷっ……！　他のメイドなど見ないで下さい、んちゅ、ご主人様には私がいるのですから、はぅ、んちゅぅっ……	그러니 주인님……!　다른 메이드들은 보지 말아 주세요…… 주인님에게는 제가 있으니까요……
んぅ～～っ……うわき、しちゃいやです……ちゅっ……ちゅっ……なんでもしますから……んちゅっ……わたくしだけを見ていて……ください……んちゅうっ……	…… 바람, 피면 싫어요………………뭐든지 할테니까………… 저만 봐……주세요…………
それともご主人様は、んちゅ、ちゅぅ、私では不満ですか……？　んんぅ、それなら直しますから、はぅ、ちゅるるぅ……何でも言って下さいぃ……！	아니면 주인님은…… 제가 불만인가요……?　……그럼 고칠테니까요…… 뭐든지 말해 주세요……!
愛してます、愛してます、愛してますからぁ……！　れろぉ、ちゅっ、ちゅぷぅっ！　見捨てないで下さいご主人様ぁ、んんぅ……ちゅるるるぅ、んちゅぷっ！	사랑해요, 사랑해요, 사랑하니까……!　…… 버리지 마세요 주인님…………!
それが嬉しくて、俺は思わずそう返事をしてしまう。	그것이 기뻐서, 나는 무심코 그렇게 대답을 한다.
ふふふふふっ、ご主人様ぁ、ふふっ……！　嬉しい、嬉しいです……！　あぁ、今日はなんて良い日なのでしょうか、愛してますご主人様ぁ……もう一度言って下さい……！	후후후후훗, 주인님, 후훗……!　기뻐, 기뻐요……!　아아, 어쩜 이렇게 좋은 날이죠, 사랑해요 주인님……한번 더 말해 주세요……!
愛してるよ。	사랑해.
ああぁっ……！　ふふふふっ、愛してます、もっともっと、たくさんご奉仕しますからぁ、ふふっ……！！	아아앗……!　후후후훗, 사랑해요, 좀 더 좀 더, 잔뜩 봉사할테니까요, 후훗……!
んむぅ、ぢゅっ！　じゅぶぶぶぶぅ！　れろぉ、んぢゅぅ……たくさん、たくさんしますね、ふふふっ！　はぅ、んぷぅ、ぢゅっ……んぢゅぅううううっ！	………………잔뜩, 잔뜩 해요…………!　………………
美味しいですぅ、んむぅ、じゅぷぅっ！　ご主人様にご奉仕できるなんてぇ、あぁ、このまま精液出して下さい、ぢゅぶぅ、私が全部飲み込みますからぁ……！	맛있어요……!　주인님에게 봉사하다니, 아아, 이대로 정액 싸 주세요…… 제가 전부 삼킬테니까요……!
ええ、もちろんです、ご主人様ぁ！　れろぉ、んぢゅ！　じゅぶぶぶぅ！　ふふふっ、私はご主人様だけのメイドなのですからぁ、んぷぅ、ぢゅるるぅ！	네, 물론이죠, 주인님!　………… 후후훗, 저는 주인님만의 메이드니까요…………!
んぢゅぅうううっ……！　んんっ、ごひゅじんひゃまぁ、んむぅ、うくっ……んぅっ！	………………주인님…………!
ふふふふっ、んちゅ、はぅっ……熱くて、濃くてぇ……あぁ、こんなにたくさん、んちゅ、ふふふっ……！	후후후훗…… 뜨겁고, 진해서…… 아아, 이렇게나 많이…… 후후훗……!
こくこく、んぅ……んくっ……美味しいです、あぁ、ご主人様、ご主人様ぁっ……嬉しいです……んぅっ……こんなに幸せな事……ありません……	………………맛있어요, 아아, 주인님, 주인님…… 기뻐요………… 이보다 행복한 일은……없어요……
ふふふっ、当然です……私は、ご主人様だけのメイドなのですから……！　それとも……ご奉仕、お気に召しませんでしたか？	후후훗, 당연해요…… 저는, 주인님만의 메이드니까요……!　아니면…… 봉사, 마음에 안 드셨어요?
ええ、もちろんです……！　ご主人様の為なら私、何でもいたしますから……！　朝まででもいつまででも……さあご主人様、お部屋で続きをしましょう……？	네, 물론이죠……!　주인님을 위해서라면 저, 뭐든지 해 드릴테니까요……!　아침까지라도 언제까지라도……자, 주인님, 방에서 계속 해야죠……?
ふふふっ……！　ねえ、ご主人様ぁ……キスしていいですか、今ここで……	후후훗……!　저기, 주인님…… 키스 해도 될까요, 지금 여기서……
んちゅ、ちゅぅ……ご主人様ぁ……はぅ……ちゅぷぅ、んちゅぅ……ちゅぱっ……！	…………주인님……………………!
だって私、ちゅぷっ……ご主人様の事、愛してますからぁ、んむぅ、ちゅるるぅ……ご主人様さえいれば、他に何もいりません、んんぅっ……	왜냐면 저…… 주인님을, 사랑하니까요…… 주인님만 있으면, 다른 건 아무 것도 필요 없어요……
ふふっ、いつまでもこうしていたいですね、んむぅ、ちゅぷぅ……胸が高鳴って、身体が熱くなってぇ、んちゅぅ、んんぅ……私ぃっ……！	후훗, 언제까지나 이렇게 하고 있고 싶네요…… 가슴이 두근 거려서, 몸이 뜨거워져서…… 저……!
んぅ、そうですね……せっかくご主人様といるのですからぁ……私ぃ、深いところまでご主人様とつながりたいです、あぁっ……	…… 그렇네요…… 모처럼 주인님이랑 있으니까…… 저, 깊은 곳까지 주인님이랑 연결되고 싶어요, 아앗……
キスだけでも充分嬉しいですけど、んぅ……私、もっともっとご主人様を味わいたいです……ふふふっ、ねえ、いいでしょう……？	키스만으로도 충분히 기쁘지만요…… 저, 좀 더 좀 더 주인님을 맛보고 싶어요…… 후후훗, 저기, 괜찮죠……?
お願いですからぁ……私の身体、どこでも使っていいです、好きにして下さいぃ……私はご主人様だけのメイドなのですから、ふふふふっ……！	부탁이에요…… 제 몸, 아무데나 써도 좋아요, 마음대로 해 주세요…… 저는 주인님만의 메이드니까요, 후후후훗……!
挿れて下さい、ご主人様ぁ……太くて硬くてぇ、逞しいモノ……奥まで突いて、掻き回してほしいんです、ふふふっ……！	넣어 주세요, 주인님…… 굵고 딱딱하고, 씩씩한 걸…… 안쪽까지 쑤셔서, 휘저어 주세요, 후후훗……!
ご主人様とせっくすするの、大好きですからぁ……キスもせっくすも、ご主人様にして頂けるなら、すぐにぐちゅぐちゅになって……はしたない声たくさん出てしまうんですぅ……	주인님이랑 섹스하는 걸, 정말 좋아하니까요……키스도 섹스도, 주인님이랑 할 수 있다면, 바로 질척질척해져서…… 부끄러운 소리가 잔뜩 나와 버려요……
ですから、あぁっ……挿れてください、ふふふっ……私を幸せにしてほしいんです、ご主人様ぁ……私も、ご主人様を幸せにして差し上げますからぁ……	그니까, 아앗…… 넣어 주세요, 후후훗…… 저를 행복하게 해 주세요, 주인님…… 저도, 주인님을 행복하게 해드릴테니까요……
んくぅぅ……あぁっ！　ご主人様のが、私の中にぃ……ふふふっ、ありがとうございます、ご主人様ぁ……！　ようやく繋がれました、あっ、んんぅ！	……아앗!　주인님의 거기가, 내 안으로…… 후후훗, 감사합니다, 주인님……!　겨우 연결되었어요, 앗……!
ふふっ、熱くて硬くてぇ、んくぅ……幸せです、ご主人様ぁ！　中で擦れて、あっあっ、すぐにぐちゅぐちゅになってしまいますね、ぁああああっ……！	후훗, 뜨겁고 딱딱하고…… 행복해요, 주인님!　안에서 비벼서…… 바로 질척질척하게 되네요, 아아아아앗……!
どうして他の誰かが、私達の愛の営みを邪魔できるのですか……？　はぁはぁっ、そのような事、考える必要はありません、んんぅ、あぁん！	어떻게 다른 사람이, 저희들의 사랑을 방해 할 수 있을까요……?　하아하앗, 그런 걸, 생각할 필요는 없어요…… 아앗!
せっかくご主人様と繋がっているのに、あぁ、くぅん！　他の方の事なんて、あっあっ、考えも及びませんでしたね……んんっ！　ぁあああっ、ひゃぁん！	모처럼 주인님과 연결되어 있는데, 아아……!　다른 사람은…… 생각을 못 했네요……!　아아아앗……!
あっ、んぐぅうう、ひぃいん！　あ、頭ぼうっとしてぇ、やぁん！　ご主人様ぁ！　私、おかしくなってしまいますぅっ……！	앗…………!　머, 머리가 멍해져서, 저!　주인님!　저, 이상해져 버려요……!
今、とても幸せで、あっあっ、んくぅん！　ぁああっ、ひぃいん！？　せっくす、せっくす好きですぅ、ご主人様ぁっ！　もっと掻き回して下さいぃ、はぅううん！	지금, 너무 행복해서……!　아아앗……!?　섹스, 섹스 좋아요, 주인님!　좀 더 휘저어 주세요……!
はぁはぁっ、一緒に、一緒にぃ！　あぁん！　私、ご主人様と一緒にイキたいですぅ……！　んくっ、ひぃん！　愛してます、愛してますからぁ、ぁあああああっ！？	하아하앗, 같이, 같이!　아앗!　저, 주인님이랑 같이 가고 싶어요……!　………… 사랑해요, 사랑하니까, 아아아아아앗!
アソコ、ぐちゅぐちゅってぇ、んんぅ！　ご主人様の咥え込んで、嬉しくなってるんですぅ、あっあっ、だからはしたないお汁こんなに溢れてぇ……！	거기, 질척질척해서……!　주인님을 꽉 물고, 기뻐하고 있어요…… 그니까 부끄러운 물이 이렇게 흘러넘쳐서……!
身体疼いてぇ、ぁあああああっ！　はぁはぁ、幸せ、私幸せですぅ！ご主人様、ご主人様ぁっ！　私の中でこんなに熱くてぇ！　私だけを見ていて下さい、ご主人様ぁっ！	몸이 달아올라서, 아아아아아앗!　하아하아, 행복해, 저 행복해요! 주인님, 주인님!　제 안에서 이렇게 뜨거워져서!　저만 봐 주세요, 주인님!
んぅううううううっ！？　あぁっ、熱いですぅ、ご主人様ぁっ……！！	………………　아앗, 뜨거워요, 주인님……!
はぁ、はぁっ……嬉しいです、ご主人様ぁ……んぅ、こんなに精液出してくださるなんて、ぁああっ……私、また疼いてしまいますぅ、ふふふふっ……！	하아, 하앗……기뻐요, 주인님……, 이렇게나 정액을 싸 주시다니, 아아앗…… 저, 또 달아올라요, 후후후훗……!
もっと、もっとしたいです……ご主人様ぁ……私にもっと、ご主人様を感じさせて下さい、私だけを感じて下さい、ご主人様っ……	좀 더, 좀 더 하고 싶어요…… 주인님…… 저에게 좀 더, 주인님을 느끼게 해 주세요, 저만을 느끼세요, 주인님……
ご主人様……硬くなってるぅ……素敵……んぅんっ……	주인님……딱딱해지고 있는 ……수려……응응……
ふふ……おはよ……ご主人様ったら、朝からおちんちんおっきくしてるんだもん……ふふ、すっごく硬くなってるよぉ……？	후후……안녕……주인님도 참, 아침부터 자지움켜 뜨고 있어 것……후후, 대단히 딱딱해지고 있는……?
えへへ……おきちゃったけど、お姉ちゃんにまだぁ……させてくれる……？	네에에……일어나버렸지만, 언니에게 아직……시켜 주어……?
ふふ、断ってもぉ、んぅっ、おちんちんしこしこしちゃうけどね……？	후후, 끊어도 , 응, 자지 쫄깃쫄깃 해버린다지만……?
んっ……んんぅっ……んぅっ……あっ、はぁっ……硬いの……しょうがないなぁ、してあげないとね……？	응……응응……응……아, 후~……딱딱한 것……어쩔 수 없다, 해 주지 않으면……?
はぁっ、はぁっ……んっ、んぅっ……！　あっ、はぅっ……お姉ちゃんの手に……出して、出してっ……	후~, 후~……응, 응……!　아, 는 ……언니의 손에……내, 내 ……
ひゃああんっ！！　ふふっ……いっぱい出したね……えらいえらい……	아 응!　후후……가득 냈군요……대단한 대단하다……
うふふ……朝からお姉ちゃんに甘やかされた気分はどうかな……？	후후……아침부터 언니에게 응석부리게 해진 기분은 어떨까……?
いや、最初はちょっと驚いたけど……気持ちよかったよ。ありがとう、お姉ちゃん。	아니, 처음은 조금 놀랐지만……기분 좋았어요. 고마워요, 언니.
あー、お姉ちゃんに甘えてデレデレご主人様になってるぅ。可愛いんだから。	아―, 언니에게 응석부려 데레데레 주인님에게 되어있는. 사랑스럽기 때문에.
……もしかして、続きを期待していいのかな？	……혹시, 계속을 기대해도 좋은 것인지?
ふふ、まだ出来るんだったら……朝ごはんの時間まで……しこしこしてあげよっか？	후후, 아직 할 수 있려면……아침 밥의 시간까지……쫄깃쫄깃 해 주어라 인가?
はぁ、はうっ……ご主人様ぁ……はむっ……	후~, ……주인님…………
はぁ……ん、ちゅ……、んっ、んっ……、あ、ご主人、さまぁ……んちゅ……	후~……응, ……, 응, 응……, 아, 주인, 님…………
……んっ、ちゅ……、ごしゅりん、さまぁ……ひもち、いい……？　んっ……れろっ……	……응, ……, 종류응, 님……히 가져, 좋아……?　응…………
んくっ……ちゅ……あ……うれしい……おちんちん……もっとしてあげるねぇ……？　んちゅうっ、れるれるぅ……	응구…………아……기쁜……자지……좀 더 해 주는군 ……?　, 날름날름 ……
んぅっ……んちゅぷっ……ちゅく、れるぅっ、ぢゅるぢゅるっ……はぁ、はぁ……もう、朝から元気なんらからぁ……ぢゅる……	응…………구, , ……후~, 후~……이제(벌써), 아침부터 건강한 응등으로부터…………
はぁ、はぁ、んちゅうう、ふふ、なにもぉ、いわなくていーよ……？　んぐちゅっ、れるぅ、はむ、んぐちゅ、れるれるっ……くぅん……	후~, 후~, 우우, 후후, 굳이 , 말하지 않아서 있고-……?　, , , , 날름날름 ……구응……
んじゅっ、じゅっ！　んっ、んくっ……はぁっ、らしてぇ、らしちゃってぇ……んふぅっ、んっ！　いっぱいひてぇ？　んぐちゅっ、んん～っ……！	,!　응, 응구……후~, 들 해 , 들 해 버려서 ……, 응!　가득 히라고?　, 응응~……!
くうぅんっ！　んむ～……ん～っ！	먹는 응!　∼……응~!
んくっ……んくっ……こくっ……はぁ、朝から濃いね……？　はぁ、はううんっ……お姉ちゃん、すっごく嬉しい……	응구……응구……진하고 ……후~, 아침부터 진하다……?　후~, 는 으응 ……언니, 대단히 기쁘다……
ふぅっ……お姉ちゃんにいっぱい出して……ふふ、全部ちゃ～んと出た……？	……언니에게 가득 내……후후, 전부~응과 나왔어……?
…………ふふ、遠慮しなくていいよ？　お姉ちゃんに甘えちゃって……？	…………후후, 사양하지 않아 좋아?　언니에게 응석부려 버려서……?
うん……いいよぉ……だって、ご主人様とお姉ちゃんは恋人だから……ふふ、何回だってしてあげるからね……	응……좋아 ……도, 주인님과 언니는 연인이니까……후후, 몇회라도 해 주니까요……
…………あ、あのね……ご主人様、その……	…………아, 저기요……주인님, 그……
キス……してほしいなって、お姉ちゃん、思っちゃった……	키스……해 주었으면 한다는, 언니, 생각해 버렸다……
……許可なんか、とらなくてもいいよ？	……허가는, 취하지 않아도 괜찮아?
ちゅっ……ちゅっ……んぅっ……ご主人様ぁ……ちゅっ……んちゅっ……好き……好き……ご主人様、好きぃ……ちゅっ、ちゅっ……	…………응……주인님………………좋아해……를 좋아하는 사람……주인님, 좋아……, ……
分かってるよぉ……でも、でもね……？　ちょっとだけ、先にぃ……ちゅーしてほしいなって、思っちゃったの……	알고 있는……에서도, 그런데……?　조금, 먼저 ……-해 주었으면 한다는, 생각해 버렸어……
んっ……もっとエッチなキス……お姉ちゃん、してほしいなぁ……？	응……좀 더 음란한 키스……언니, 해 주었으면 한다……?
はぁ、んちゅっ……じゅるるっ……はううっ……わたし、はぁ、はううっ……じゅるるぅ……キス……すきぃ……	후~, …………는 우우……나, 후~, 는 우우…………키스……좋아……
はぁ……んちゅうっ……ご主人様の味ぃ……好きぃっ……んちゅっ……ちゅぷぅっ……くぅううんっ……はぁ、はぁっ……	후~…………주인님의 맛……를 좋아하는 사람………………구으응 ……후~, 후~……
はぁ……ご主人様……お姉ちゃん……お姉ちゃんね……うぅっ……	후~……주인님……언니……언니…………
んっ……そう……でも、でもね……ここじゃ……やっぱり……はずかしいかな……	응……그렇게……에서도, 그런데……여기는……역시……부끄러울까……
どきどきしてるぅ……その、もう、はやく可愛がって……？　お姉ちゃん、あたまがおかしくなっちゃいそうなの……	두근두근 하고 있는 ……그, 이제(벌써), 빨리 귀여워해……?　언니, 머리가 이상해져버릴 것 같아……
ご主人様……じっとしててね……？	주인님……가만히 하고 있어……?
え、えへへ……おちんちん……出しちゃった……硬くなってるぅ……♪	네, 네에에……자지……내 버렸다……딱딱해지고 있는 ……♪
あう……？　そうかな……？　んちゅっ……全然気にならない……むしろご主人様の匂いがして……好きぃ……	만나……?　그럴까……?　……전혀 신경이 쓰이지 않는……오히려 주인님의 냄새가 나……를 좋아하는 사람……
んちゅうっ……ちゅううっ……おしっこの味するぅ……でも、お姉ちゃん、ご主人様のなら……平気だよ……？	……우우……오줌의 맛 한다……에서도, 언니, 주인님의 것이라면……아무렇지도 않아……?
ぐちゅっ……ちゅぷっ……お姉ちゃん、もうどきどきが止まらないのぉ……ちゅぷ、ちゅぷぅっ……	…………언니, 이제 두근두근이 멈추지 않는 것 ……, ……
はぁ、はぁ……んつ……ご主人様だってぇ、こういうの、好きでしょ……？	후~, 후~……응개……주인 같다고 , 이런 것, 좋아하겠지……?
ぐちゅっ、はぁ、はぁ、ちゅぷ、んぅっ！　えへへ、お姉ちゃん、ご奉仕すきぃ……んちゅっ、れるぅっ、はぁ、はぁ、んぅうんっ……！	, 후~, 후~, , 응!　네에에, 언니, 봉사 좋아……, , 후~, 후~, 응응 ……!
おしっこもぉ、あせもぉ……ご主人様なら全部平気ぃ……んちゅううっ！　はぁ、はぁ、すきすきっ……すきぃっ……！	오줌도 , 땀띠……주인 같으면 전부 태연……우우!　후~, 후~, 비어 좋아……좋아……!
んぅっ……はぁ、はぁっ……ぐちゅっ！　ひくひくしてるぅっ……らしたいんだぁ？　んぷっ、んん～っ……！	응……후~, 후~……!　흠칫흠칫 하고 있는 ……등 하고 싶거든?　, 응응~……!
こくっ……んっ……ふふっ……こくんっ……えへへ……いっぱぁい……全部残さず……飲んだよ……？	진하고 ……응……후후……진하고 응……네에에……있고……전부 남기지 않고……마셨어……?
あ、でもね……こんなにいっぱい出しちゃったらぁ……この後のぶん、なくなっちゃうかも……？	아, 그런데……이렇게 가득 내 버렸다들……이 후의 만큼, 없어져버릴까도……?
んっ……続きはお部屋で……だよね？　お姉ちゃん、いっぱい精液欲しいな……え、えっちすぎるかなぁ……♪	응……다음은 방에서……지요?　언니, 가득 정액 갖고 싶다……네, 지날까……♪
……あの……ご主人様ぁ……ちゅー……してぇ……？	……그……주인님……―……해 ……?
ちゅっ……はぁ、はぅっ……ごめんねぇ……すぐ、ちゅーしたくなっちゃたぁ……	……후~, 는 ……미안해요……곧, -하고 싶고 ……
んっ……あ、あのね……お姉ちゃんね……えっとぉ……その……	응……아, 저기요……언니……어와 ……그……
お姉ちゃんね、最初はちゅーしたら……その、我慢できるかなって思ったの……けど、違ったよ……	언니, 처음-하면(자)……그, 참을 수 있을까라고 생각한 것……하지만, 달랐어……
もっとしてほしいって、そればっかり考えちゃう……我慢なんて……できるはずないよ……	좀 더 해 주었으면 한다고, 그것뿐 생각해버리는……인내는……할 수 있을 리 않아……
あ、あのっ……あのっ……お姉ちゃんのここにね……その……	아, 그 ……그 ……언니의 여기에 말이야……그……
あう……せ、セックスだよう……ご主人様だって、したいよね……？	만나는……키, 섹스……주인 같다고, 하고 싶지요……?
んっ……ご、ご主人様の……おちんちん……はぁ、はぁ……おまんこに入れてぇ……ご主人様ぁ、焦らさないでぇ……はぁ……	응……, 주인님의……자지……후~, 후~……보지에 넣어 ……주인님, 초조하게 하지 말고 ……후~……
お姉ちゃんの……触ってもないのに、発情してぐちゅぐちゅになってるおまんこにぃ……おちんちん突っ込んで……せ、セックスしてほしいのぉ……はぁああんっ……	언니가……손대지 않았는데, 발정가 되어있는 보지에 ……자지 돌진해……키, 섹스 해 주었으면 하는 것 ……후~ 아 응……
あうっ……や、やぁあああんっ……ご、ご主人様、はげしっ……激しいよぉっ……はぁ、あうっ……きゃうううっ……！	만나는 ……나, 나아 팥고물……, 주인님, 벗길 수 있는 쉿……격렬해 ……후~, 만나는 ……우우……!
ああ、ああうっ……おかしいよねっ……お姉ちゃんね……おまんこいっぱい濡らしちゃってたからぁっ……はぁあんっ……	아, 아 만나는 ……이상하지요 ……언니……만 진한 유로부터……후~ 팥고물……
キスしたら、じゅんってぇ……じゅんって、エッチなの溢れてきちゃったぁ……はぁ、はうっ……ご主人様、ご主人様っ……！	키스 하면(자), 순서는 ……순서는, 음란한 흘러넘쳐 와 버렸다……후~, ……주인님, 주인님……!
ああ、はぁあっ……はううっ……ご主人様っ……ごめんね、えっちなお姉ちゃんでぇ……ごめんなさいぃ、はぁ、はううっ……！	아, 후~아……는 우우……주인님……미안해요, 더 언니(누나) 로 ……미안해요 , 후~, 는 우우……!
お部屋まで我慢できない、はぁ、はぁ、はしたないメイドなのぉ……はぁ、はうっ……！	방까지 참을 수 없는, 후~, 후~, 상스러운 메이드인 것 ……후~, ……!
あひっ！　はぁ、はぁああっ……！　はげし、激しいのっ！　ご、ご主人様っ！　ご主人様ぁ～っ！	아히!　후~, 후~ 아 ……!　벗길 수 있는 해, 격렬한 것!　, 주인님!　주인님~!
ああ、はああっ、おまんこのおくもっとぉ、おちんちんぐりぐりしてぇ、それが、それがいちばんだからぁ……！	아, 는 아 , 보지의 속 좀 더 , 자지 때굴때굴 해 , 그것이, 그것이 가장이니까……!
はぁ、はぁっ……ご主人様ご主人様……全部ご主人様のモノだからぁ……はぁ、はひっ……んぅうんっ……！	후~, 후~……주인님 주인님……전부 주인님의 물건이니까……후~, 는 히……응응 ……!
あひっ！　あひぃっ……！　うふふっ、うれしいっ……ああ、ご主人様にぃ、一晩中……えっちなことっ……！　あうう、お姉ちゃん、幸せ過ぎてぇ、泣いちゃいそうだよぉっ……！　んんん～っ！	아히!　아히……!　후후, 기쁜 ……아, 주인님에게, 밤새……인 일……!　아우우, 언니, 너무 행복해 , 울어버릴 것 같아 ……!　응응응~!
はぁ……はぁあんっ……ご主人様……うれしい……おねだりしてよかったぁ……大好きぃ……ご主人様ぁ……	후~……후~ 팥고물……주인님……기쁜……졸라댐 해서 좋았다고……너무 좋아……주인님……
んっ……ふふっ……ご主人様がぁ、こんな……おまんこおねだりするメイドにしたのぉ……だからぁ、責任とってぇ……一晩中可愛がってね……？	응……후후……주인님이, 이런……보지 졸라댐 하는 메이드로 한 것 ……이니까, 책임져 ……밤새 귀여워해……?
ご主人様……あのね……はしたないってぇ……わ、分かってるんだけど……	주인님……저기요……상스럽다는 ……원, 알고 있었지만……
…………ここで、お姉ちゃんの事……い、苛めて……ほしいの……	…………여기서, 언니의 일……있고, 괴롭히기를……원하는거야……
ごめんね……でも、その……お話している時から……実は、はやくしたいなぁって、む、むらむらしちゃって……	미안해요……에서도, 그……이야기 하고 있을 때로부터……실은, 빠르게 하고 싶다는, , 불끈불끈 해 버려서……
だからね、その……エッチなお姉ちゃんに……イラマチオ、してほしいの……	(이)니까, 그……음란한 언니에게……이라마치오, 해 주었으면 하는거야……
ぷはっ……はぁあんっ……ご、ごめん……喉奥、その……犯されても……ご主人様なら、うぅっ……もっともっとって、思っちゃうから……ごめんなさいぃっ……	하……후~ 팥고물……, 미안……목 안, 그……범해져도……주인 같으면, ……좀더 좀더는, 생각해버리니까……미안해요 ……
んっ……お姉ちゃんのおくちで興奮してぇ……オナホみたいに使ってくれてるの……幸せって……はぁ、はぁ、思うからぁ……	응……언니입으로 흥분해 ……오나홀같이 사용해 주어……행복하다는 것은……후~, 후~, 생각하기 때문……
んんん～～～っ！！　んぐぅ、うぇええっ、んぷっ、んぅうんっ！　はぁ、はぁ、もっとぉっ……！	응응응∼~~!　, 예, , 응응!　후~, 후~, 좀 더 ……!
んっ……んくっ……んくっ……こくっ……んぷっ……はぁ、はぁ……うふふ……はぁ、いっぱいらぁ……	응……응구……응구……진하고 …………후~, 후~……후후……후~, 가득들……
お姉ちゃん……んっ……んぅっ……ご主人様の性奴隷になれてるぅ……？　ねぇ、どうかなぁ……？	언니……응……응……주인님의 성 노예가 될 수 있어있는 ……?　응 아무쪼록인……?
う、うんっ……！　はぁ、いくらでも好きにしていいよ……？　ううん、いっぱい乱暴してぇ……？　はぁ、はぁっ……	, 응 ……!　후~, 얼마든지 마음대로 해도 좋아……?　으응, 가득 난폭해 ……?　후~, 후~……
えっとぉ……その、ご主人様……お部屋まで……ま、待てないの……はぁ、はぁ……ふふっ……だからね……？	어와 ……그, 주인님……방까지……뭐, 기다릴 수 없는 것……후~, 후~……후후……니까……?
いいよう……むしろ、その……ちょっとぐらい、痛い方がぁ……	좋게……오히려, 그……조금 정도로, 아픈 것이……
んっ……あのね、早くしないとぉ……触らなくても濡れちゃうから……痛いのがいいの、ご主人様……はやくぅ……	응……저기요, 빨리 하지 않으면 ……손대지 않아도 젖어버리니까……아픈 것이 좋은 것, 주인님……빠르게 ……
んぁあああっ……！！　はぁ、はぁ、くる、しっ……よぉっ……んんん～～～っ……！	응아 아……!　후~, 후~, 온다, 쉿…………응응응∼~~……!
はぁ、はぁっ……痛くてぇ、どきどきしちゃうのぉ……はぁ、はひっ……んんんっ……	후~, 후~……아파서 , 두근두근 해버린다의 ……후~, 는 히……응응응……
あ、あうっ……あのねっ……？　叩いてくれたら……アソコ、きゅーってなるよっ……？　だからね……えへへ……はぁあ、はうんっ……	아, 만나는 ……저기요 ……?　두드려 주면(자)……아소코, 라고 되어 ……?　(이)니까……에에……후~아, 는 응 ……
いっぱい叩いて……？　変態お姉ちゃんのお尻……叩かれたがってるのぉ……んぅんっ……	가득 두드려……?　변태 언니의 엉덩이……얻어맞았지만 비치는 것 ……응응……
ぅあああっ……！？　ひぃいんっ……！　はぁ、はぁっ……ご主人様、ご主人様……叩かれたったよぉ……んぅんっ……	아 아……!　히있는 ……!　후~, 후~……주인님, 주인님……두드려진 야 ……응응……
はぁ、はううっ……ご主人様……ど、どうかなぁ……？　気持ちいいかなぁ……？　はぁ、あひっ……ひぃいんっ……	후~, 는 우우……주인님……아무쪼록인……?　기분이 좋을까……?　후~, 아히……히있는 ……
ぁああっ……ひぅうっ……い、いたっ……いたいのぉっ……♪　激しいよぉ……くぅうんっ……はぁあっ……はひっ……	아 …………있고, 있던 ……아픈 것 ……♪　격렬해 ……구응 ……후~아……는 히……
だって、だってねっ……ご、ご主人様がすることだから、嬉しくて……はぁ、はひっ……やぁああん……	왜냐하면, 이래……, 주인님이 하는 것이니까, 기뻐서……후~, 는 히……나아 응……
あああ、じんじんしてるぅ、はぁ、はひっ……！　お姉ちゃん、お姉ちゃんはっ……あぁああ～～っ……！	아 아, 지릿지릿 하고 있는 , 후~, 는 히……!　언니, 언니는 ……아아∼~……!
はぁ、はひっ……ひぃいっ……！　お部屋にねぇ……行かないといけないのにぃ……お姉ちゃん……ぁああ～～っ……！	후~, 는 히……히있고 ……!　방에 말이야 ……가지 않으면 안 되는데 ……언니……아∼~……!
あはぁ、はぁ、やぁあああんっ！　ごめんねっ……ああ、ああああ……！　ご主人様、ご主人様っ……ひぐぅうっ……！	아는, 후~, 나아 팥고물!　미안해요……아, 아 아……!　주인님, 주인님…………!
ああ、あああっ……さ、最後までっ……しゃせーまでっ……お願い……ごめんね、お姉ちゃん、待ってるのぉっ……！	아, 아 아……, 끝까지 ……감사할 수 있다-까지 ……부탁……미안해요, 언니, 기다려 ……!
んぁっ、出てる……！　んぅっ！　んぁあ～～～～っ……！！	응, 나오고 있다……!　응!　응∼~~~……!
んぅんっ……はぁ、はひっ……ひぃいんっ……おまんこもぉ……おひりもじんじんしてるぅ……くぅううんっ……	응응……후~, 는 히……히있는 ……보지도 ……도 지릿지릿 하고 있는 ……구으응 ……
こんなにも……だ、出してくれたんらぁ……？　あううっ……エッチ過ぎるお姉ちゃんで……ごめんね……？　はぁ、はううん……	이렇게도……다, 내 준 등……?　아우우……너무 음란한 언니로……미안해요……?　후~, 는 으응……
う、うんっ……トクベツ……トクベツなんだぁ……えへへ……大好きだよ、ご主人様……	, 응 ……트크베트……트크베트야……에에……정말 좋아해, 주인님……
ご主人様……この後も……もう、お姉ちゃんの事、壊しちゃってもいいからね……？　くぅうんっ……	주인님……이 후도……이제(벌써), 언니의 일, 부수어 버려서도 좋으니까……?　구응 ……
……ご主人様……その……お姉ちゃんね……酔っちゃった……えっと……ぼーっとしちゃうの……	……주인님……그……언니……취해 버렸다……어와……-로 해버린다의……
ちょっとだけでもいいけど……その……お姉ちゃんの身体……触ってぇ……？	조금이라도 좋지만……그……언니의 신체……손대어 ……?
あう……もう我慢できないの……ずっとエッチな事……考えてたら……ご主人様ぁ……	만나는……이제 참을 수 없는 것……훨씬 음란한 일……생각하고 있으면(자)……주인님……
あ、ぅっ……で、でも……いいのかな……？　ご主人様がいるのに……	아, ……로, 라도……좋은 것인지……?　주인님이 있는데……
うぅっ……意地悪……でも、その……ご主人様がいいって言うのなら……	……심술쟁이……라도, 그……주인님이 좋다고 말한다면……
あはっ……お姉ちゃんのおまんこ……触っても無いのに……はぁ、はぁ、最初からぐちゅぐちゅだったのっ……	아는 ……언니의 보지……손대어도 없는데……후~, 후~, 최초나들 였던 것 ……
ああ、あうっ……そ、そうかも……お話している時から……え、エッチしたかったからぁ……	아, 만나는 ……, 그럴지도……이야기 하고 있을 때로부터……네, 섹스하고 싶었으니까……
んっ……ご主人様もエッチな目してて……お姉ちゃんとエッチしたいんだなぁって……勝手に妄想しちゃってたぁ……	응……주인님도 음란한 눈 하고 있어……언니와 섹스하고 싶다는……마음대로 망상……
う、うんっ……ずっと楽しみにしてたの……何をされるんだろうとかぁ……エッチな事いっぱいしてほしいなってぇ……はううん……	, 응 ……쭉 기대했어……무엇을 하실 것이라고인가……음란한 일 가득 해 주었으면 한다는 ……는 으응……
はぁ、はうっ……う、うんっ……おまんこいっぱい……くちゅくちゅしたいっ……もっと、もっとぉ……激しく……ああっ……くぅん……	후~, ……, 응 ……보지 가득……하고 싶은 ……좀 더, 좀 더 ……격렬하고……아 ……구응……
はぁ、はひっ……いいの……？　分かったぁ、じゃあ、するねっ……？　はぁ、はぁっ……ご主人様、ご主人様っ……あぁあ……	후~, 는 히……좋은거야……?　알았다, 자, 하는군 ……?　후~, 후~……주인님, 주인님……아……
……ご主人様……イって、いいのっ……お姉ちゃん……ああ……！　んぁっ、はぁ、はううっ、ひぅうっ！　はぁ、あうっ、あうっ	……주인님……이는, 좋은 것 ……언니……아……!　응, 후~, 는 우우,!　후~, 만나는 , 만난다
はぁ、はぁあっ……はぁあんっ……ご、ご主人様の前でぇ……はぁ、はひっ……クリトリス、くりくりしてるぅ……はぁ、はうう……くぅうんっ……	후~, 후~아……후~ 팥고물……, 주인님의 앞에서 ……후~, 는 히……클리토리스, 동글동글 하고 있는 ……후~, 는 우우……구응 ……
う、うんっ……そうだよ……？　はぁ、はぁ……ご主人様ならどうやって触るかな、とかぁ……んぅっ……いっぱい、いっぱい想像してぇ……はぁあん……！	, 응 ……그래……?　후~, 후~……주인 같으면 어떻게 손댈까, 라든지…………가득, 가득 상상해 ……후~ 팥고물……!
ごめんねっ……！　はぁ、はぁ、イっちゃうよっ……イっちゃううっ……イカせてぇっ……！　はぁ、はひっ……んんん～～っ！	미안해요……!　후~, 후~, 이야 ……이우우……오징어키라고 ……!　후~, 는 히……응응응∼~!
ひゃ、んぅっ……！　んくっ！　イくぅううううっ……！	, 응……!　응구!　이구우우 우우……!
はぁ、はひ……す、すごいのぉ……すごい、よぉっ……はぁ、はひっ……ぁああんっ……ご主人様ぁ……	후~, 는 히……, 대단히의 ……대단히, ……후~, 는 히……아 응……주인님……
よっぱらってぇ……おなにーしてぇ……ああ、お姉ちゃん、頭まっしろだよぉ……	취해 ……뭐-해 ……아, 언니, 머리해라야 ……
ああ……えへへ……しょ、しょうらね……？　もっと、ご主人様に……きもちよくしてもらうんらよね……？　えへへ、うれし……	아……네에에……실마리, 짊어지는들……?　좀 더, 주인님에게……기분 자주(잘) 받는 등이군요……?　네에에, 팔 수 있는 해……
んっ……わたしね……ご主人様なら、なんでもぉ……かんじちゃうとおもうのぉ……えへへぇ、エッチなお姉ちゃんでごめんね……？	응……나……주인 같으면, 뭐든지 ……느껴버리자(면) 생각하는 것 ……네에에 , 음란한 언니로 미안해요……?
あう……んっ……ご、ごめんね……？　ご主人様ぁ……先、お部屋に行っててくれないかなぁ……？	만나는…………, 미안해요……?　주인님……앞, 방에 가고 있어 주지 않을까……?
……あの、お姉ちゃん、いっぱい飲んでたでしょ……？　だから、ちょっと、そのぉ……あのぉ……	……저, 언니, 가득 마시고 있었던이겠지……?　그러니까, 조금, 그 ……그-……
うん……おといれ、いってくるね……？	응……소리 넣어 갔다 오는군……?
…………き、きたなくないかなぁ……？	…………와, 더럽지 않을까……?
あう……ご、ご主人様に……そう言われちゃったら……あうっ……くぅうん……	만나는……, 주인님에게……그렇게 말해져 버렸다들……만나는 ……구응……
お姉ちゃん、ご主人様以外は見られたくないよ……？　だ、だれか……こないか……みていてね……？	언니, 주인님 이외는 볼 수 있고 싶지 않아……?　(이)다, 누군가……오지 않을까……보고 있어……?
あうう……意地悪、意地悪っ……あうっ……あ、あれっ……？　み、見られてるとぉ……お、おしっこ、出ないよぉ……くぅん……	아우우……심술쟁이, 심술쟁이……만나는 ……아, 저것……?　보고, 볼 수 있고 있다고(면) ……, 오줌, 나오지 않아 ……구응……
ご主人様のえっちぃ……そ、そんな……おまんこみないでぇ……じろじろ見られてると……ああ、あうっ……	주인님의 ……, 그런……보지 보지 말고 ……빤히 볼 수 있고 있다고(면)……아, 만난다 ……
や、やんっ……分かったよう……い、いたずらは……しないでね……？　はぁ、んぅんっ……んんん～～っ……！	(이)나, ……안 듯……있고, 장난은……하지 않도록……?　후~, 응응……응응응∼~……!
あ……ああっ……あううっ……おしっこ、出そうっ……おしっこ出そうなのっ……はぁ、はひっ……お姉ちゃん、あぁあっ……！	아……아 ……아우우……오줌, 내자 ……오줌 내자인 것 ……후~, 는 히……언니, 아……!
あっ……あううううっ……はうううっ……とまらないよぉっ……！	아……아우우 우우……우우……멈추지 않아 ……!
はぁ、はひっ……ご主人様ぁ……出しちゃったぁ……はぁあっ……んぅんっ……これで、いいかなぁ……？　楽しんでくれた……？	후~, 는 히……주인님……내 버렸다……후~아……응응……이것으로, 좋을까……?　즐겨 주었어……?
はぁ……はうっ……えっと、ごめんね……？　ひょっとして、悪いお姉ちゃんに……おしおきかなぁ……？	후~…………어와 미안해요……?　혹시, 나쁜 언니에게……벌일까……?
んっ……えへへ……わかったよ……んっ……お姉ちゃんね……ご主人様におしおきされたぁい……	응……네에에……알았어…………언니……주인님에게 벌 되었다있고……
えへへぇ……お姉ちゃんね……今日はご主人様にぃ……いっぱい、い～っぱい、してもらえるんだよね……？	네에에 ……언니……오늘은 주인님에게……가득, 있고~있고, 해 줄 수 있어……?
そうかなぁ……？　お姉ちゃん、ちょっとだけ正直になってるだけだよぉ……？	그럴까……?　언니, 조금 정직하게 되고 있을 뿐이야 ……?
ああ、あうっ……ご主人様ぁ……あの、お、お部屋ね……行く前にね……？　ちょっとだけね……えっちなこと、してほしいなぁって、思っちゃったぁ……くぅん……	아, 만나는 ……주인님……저, , 방이군요……가기 전에 말이야……?　조금……인 일, 해 주었으면 한다는, 생각해 버렸다……구응……
だって、だってぇ……身体熱いからぁ……シャワーだって、んっ……入らなくてもいいかなって思っちゃってるよ……？　すぐにしたいからぁ……	왜냐하면, 이래 ……신체 뜨겁기 때문에……샤워도, 응……들어가지 않아도 괜찮을까라고 생각해 버린다……?　곧바로 하고 싶기 때문에……
はぁっ……んっ……ご、ご主人様ぁ……手、熱いね……？　はぁ、はぁっ……くぅんっ……	후~……응……, 주인님……손, 뜨겁다……?　후~, 후~……구응……
んっ……おちんちん、欲しいに決まってるよぉ……でも、でも……この後もしてくれるんだよね……？　だったら、今は触るだけでいいかも……くぅんつ……	응……자지, 갖고 싶은으로 정해져있는……에서도, 그렇지만……이 후도 해 주어……?　그렇다면, 지금은 손대는 것만으로 좋을지도……구응개……
後でぇ……お姉ちゃんのおまんこ、おちんちんでいっぱいいじめてね……？　約束だよ……？	다음에 ……언니의 보지, 자지로 많이 있고 글자째라고……?　약속이야……?
しないよ、しないようっ……逆……はぁ、はぁ……イっちゃったらぁ……きっとご主人様に……もっともっとって、思っちゃう……くぅんっ……	하지 않아, 하지 않게 ……역……후~, 후~……이도 참……반드시 주인님에게……좀더 좀더는, 생각해버리는……구응……
ああ、あはぁあ……ふふっ……音しちゃってるぅっ……濡れてるからぁ……はぁ、はひっ……くぅううんっ……ひゃううっ……	아, 아는……후후……음 해 버린다 ……젖고 있으니……후~, 는 히……구으응 ……우우……
ああ、あああっ……くちゅくちゅってぇ、セックスしてるときみたいな音なってるぅっ……おまんこ、とろとろにされて……垂れてきちゃってるよぉっ……	아, 아 아……는 , 섹스 하고 있다고(면) 기미타 좋은 소리 되어있는 ……보지, 녹진녹진로 되어……늘어져 와 버린다……
はぁ、はぁ、そ、そこっ……おへその、裏側みたいなところ……もっと、もっと、ぐりぐりってぇ、んんん～～っ……！	후~, 후~, , 거기……배꼽의, 뒤편같은 곳……좀 더, 좀 더, 때굴때굴은 , 응응응∼~……!
あああ、やだぁ、はやいよぉ、なんか、なんかきちゃうのっ……ああ、だめだめぇ、だめなのに……もう、もうイっちゃいそうなの……だめぇええっ……！	아 아, 나다, 빨라 , 어쩐지, 어쩐지 와버린다의 ……아, 안된다 째, 안된데……이제(벌써), 이제(벌써) 이있을 것 같은……안돼예……!
ああ、はぁああっ……はいっ……ん……！　ご主人様、ご主人様ぁ！　お姉ちゃん、堪らなくて……はぁ、はひっ……はううっ……！	아, 후~ 아 ……네……응……!　주인님, 주인님!　언니, 감등 없어서……후~, 는 히……는 우우……!
はぁ、はぁあっ……あたままっしろぉ……んぅっ……わけわかんなく……なっちゃったぁ……はぁはひっ……くぅうんっ……	후~, 후~아……해라 ……응……나누고 모르게……되어 버렸다……후~는 히……구응 ……
幸せだよ……ご主人様……はぁ、はぁっ……エッチな事してもらうの……すっごくすきぃ……いくらされても……飽きないよ……	행복해……주인님……후~, 후~……음란한 일 받는 것……대단히 비어 ……아무리 되어도……질리지 않아……
あ、あのっ……やっぱり、一回じゃ……ダメ、だね……？　はやく……はやくぅ……おちんちんほしいなぁ……お部屋にぃ、いこ……？	아, 그 ……역시, 1회는……안 됨, 이구나……?　빠르게……빠르게 ……자지 가지고 싶다……방에 , 있고 와……?
うぅっ……ご主人様、さっき、一緒にお話ししている時にさ……他のメイドの事見てなかったかなぁ……？	……주인님, 조금 전, 함께 이야기하고 있을 때에 ……다른 메이드의 일 보지 않았지……?
…………お姉ちゃんと一緒におしゃべりしている時にね……他のメイドを見るのは、ちょっと失礼じゃないかなぁ……？	…………언니와 함께 이야기 하고 있을 때에 말이야……다른 메이드를 보는 것은, 조금 실례가 아닐까……?
むぅっ……お姉ちゃんね、そういう余裕なところ……好きじゃないかも……	……언니, 그러한 여유인 곳……을 좋아하지 않을지도……
んっ……お部屋に行く前にね……ちょっとだけ、お仕置きだよ……？　他のメイドの事……見ちゃ……ダメだからぁ……	응……방에 가기 전에 말이야……조금, 벌이야……?　다른 메이드의 일……보면……안되기 때문에……
はぁ……はぁ……れるっ……んぅんっ……くちゅっ……ふふ……上手だよね……？　ねぇ、んちゅっ……どうかなぁ……？	후~……후~…………응응…………후후……능숙하지……?　응, ……어떨까……?
はぁ、はぁ……お姉ちゃんなら、何でもできるよ……？　んちゅ……こんなに一生懸命しゃぶっちゃうのぉ……ちゅう、ちゅううつ……	후~, 후~……언니라면, 뭐든지 할 수 있어……?　……이렇게 열심히 빨아버린다의 ……, 우우개……
お姉ちゃん以外の女の子……見ちゃだめ……お姉ちゃんが一番じゃなきゃ……やだぁ……だからぁ……んちゅうっ……れるぅっ……	언니 이외의 여자 아이……보면 안돼……언니가 제일이 아니면……이나다……이니까………………
はぁ、はぅっ……くちゅっ！　んぅっ、んぅっ、ちゅっ、ほんとかなぁ……んちゅっ、ちゅうううっ、ぅうっ、ごひゅじんひゃまぁ……んちゅっ……	후~, 는 ……!　응, 응, , 정말일까……, 우우, , 글자응아무튼…………
んちゅううっ……お姉ちゃんがぁ……せかいでいちばんらからぁ…………んぐちゅっ……れるれるぅっ……はぁ、はぁ、ぐちゅっ……れるぅっ……	우우……언니가……세계에서 가장들로부터………………날름날름 ……후~, 후~, …………
ぷはあっ……ふふっ……んうっ……聞こえなかったぁ……うふふっ……もういっかい……	는 ……후후…………들리지 않았다……후후……다시 한 번……
はぁ……はぁ……わたしもだいすきだよぉ……えへへぇ……んぅんっ……んちゅううっ……	후~……후~……나도 너무 좋아야 ……네에에 ……응응……우우……
はぁ……んぐちゅっ……らしてぇ、らしてぇ……ぜんぶのんじゃうよぉ……？　はぁ、はぁ……お姉ちゃんがんばるのぉ……んぅんっ……んんんっ……	후~…………등 해 , 들 해 ……전부의 야 ……?　후~, 후~……언니 노력하는 것 ……응응……응응응……
ふふっ……お姉ちゃん、平気だよぉ……？　飲んじゃうからぁ……んぅっ、んぷちゅっ……じゅるるるっ……はぁあんっ……んぷちゅううっ……んんぅんっ……	후후……언니, 아무렇지도 않아 ……?　마셔버리니까……, …………후~ 팥고물……우우……응응응……
ん、くっ……んぅんっ……こくっ……はぁ、はぁ……たくさんらね……ふふっ……エッチなご主人様……しょうがないなぁ……んぅ……	응, 구……응응……진하고 ……후~, 후~……많이들……후후……음란한 주인님……어쩔 수 없다……응……
はぁ、はぁ……うふふ、お姉ちゃんに甘えたみたいだね……えへへ、いっぱい出しちゃったもんね……くぅんっ……	후~, 후~……후후, 언니에게 응석부린 것 같다……에에, 가득 내 버렸다 것이군요……구응……
えへへ……お姉ちゃんは何でもいいよ……？　いくらでもしてあげる……いっぱい……いっぱいご奉仕したいな……	네에에……언니는 뭐든지 좋아……?　얼마든지 해 주는……가득……가득 봉사하고 싶은데……
ご主人様、ご主人様ぁ……ふふっ……ちゅーしていい……？	주인님, 주인님……후후……-해도 좋아……?
んっ……もっとぉ……もっとらから……えへへっ……んちゅうっ……ちゅううっ……	응……좀 더 ……좀 더들로부터……에에 …………우우……
ちゅっ……ちゅっ……お姉ちゃんね……今、こうしてるのぉ……一番好きぃ……んぅんっ……	…………언니……지금, 이렇게 해 ……제일을 좋아하는 사람……응응……
ちゅぷっ……れるっ……れるぅっ……ご主人様ぁ……好きぃっ……んちゅっ……れるえれるっ……はぁんっ……んちゅううっ……	………………주인님……좋아해 ………………후~응……우우……
あ、そうだね……んぅんっ……お姉ちゃん、どうしたらいいかなぁ……？　あう、それはこまるもん……	아, 그렇다……응응……언니, 어떻게 하면 좋을까……?　만나는, 그것은 난처한 걸……
やだやだぁ～っ……ご主人様とぉ、エッチな事もしたいのぉ、したいしたい～っ……	(이)나다나다~……주인님과 , 음란한 일도 하고 싶은 것 , 하고 싶고 싶은~……
お姉ちゃんに……エッチな事、して……？　はぁ、はうっ……はしたないお姉ちゃんでごめん……でも、してほしくってしょうがなくなってるからぁっ……	언니에게……음란한 일, 해……?　후~, ……상스러운 언니로 미안……에서도, 해 주었으면 해서 어쩔 수 없게 되고 있으니……
ご主人様のおちんちん……ほしいなぁ……んぅんっ……はぁ、はぁ、お姉ちゃん、セックスしたいようっ……んぅん……	주인님의 자지……가지고 싶다……응응……후~, 후~, 언니, 섹스 하고 싶게 ……응응……
あのね、ご主人様とセックスしてる時もぉ……キスと同じぐらい……し、幸せななのぉ……だから、だからっ……	저기요, 주인님과 섹스 하고 있는 때도 ……키스와 같은 정도……해, 행복한인 것 ……이니까, 그러니까 ……
はぁ……はぁ……しょうがない私に……んぅっ……おちんちんください……お姉ちゃんを、幸せに……してほしいのぉ……んぅんっ……	후~……후~……어쩔 수 없는 나에게…………자지 주세요……언니를, 행복하게……해 주었으면 하는 것 ……응응……
ああっ……！　ひぐっ、ひぃいっ……！　嬉しいよぉ……ご、ご主人様っ……もっとぉっ……	아 ……!　, 히있고 ……!　기뻐 ……, 주인님……좀 더 ……
はぁ、はぁっ……おちんちん、がちがちっ……ぁあ、これ、これっ……好きぃっ……幸せぇ……はぁ、はひっ……！	후~, 후~……자지, 딱딱 ……, 이것, 이것……를 좋아하는 사람……행복……후~, 는 히……!
あぅっ……ご、ごめんねっ……お姉ちゃん、おちんちん欲しくてぇ……何も考えてなかったぁ……はぅうんっ……	아……, 미안해요……언니, 자지 갖고 싶어서 ……아무것도 생각하지 않았다……는 응 ……
ああ、わたしね、セックスの事しか考えてなくてぇ……ご主人様以外には見られたくないのにぃ……はぁあん……	아, 나, 섹스의 일 밖에 생각하지 않아서 ……주인님 이외에는 볼 수 있고 싶지 않은데 ……후~ 팥고물……
おさけ、のみすぎちゃってるから……！　はぁ、はうっ、ひゃうっ、はあぁっ！　ごめんねっ！　はぁ、はううっ！	술, 너무 마셔 버린다 로부터……!　후~, , , 는!　미안해요!　후~, 는 우우!
お姉ちゃん、幸せなのぉっ！　はぁ、はぁっ……お客様となら、んっ！　どこでだってぇ、んぅっ、一緒にぃ、はぁあっ……！	언니, 행복한!　후~, 후~……손님과라면, 응!　어디서래 , 응, 함께 , 후~아……!
お姉ちゃん……！　はぁ、はひっ……熱いのちょうだい……はぁ、はひっ……！　おちんちん奥にぐりぐりしてぇっ……！	언니……!　후~, 는 히……뜨거운 것 줘……후~, 는 히……!　자지안쪽에 때굴때굴 해 ……!
激しくて……！　おまんこぉ、やけどしちゃうよぉっ……！　ん！　んぅっ、はぁ、はひっ……！　ひぐぅっ！　	격렬해서……!　보지, 화상 해버린다……!　응!　응, 후~, 는 히……!　!　
あああ、お姉ちゃんっ！　お姉ちゃん……お姉ちゃん……も、もうだめぇっ……お姉ちゃん、こわれちゃうよぉ……んぅんっ…	아 아, 언니!　언니……언니……도, 이제(벌써) 안돼……언니, 부서져버린다……응응…
ああっ……えへへぇ……お姉ちゃん、とっても幸せぇ……はぁ、はひっ……ひぃいんっ……あのね……んっ……身体、熱いの……	아 ……네에에 ……언니, 매우 행복……후~, 는 히……히있는 ……저기요……응……신체, 뜨거운거야……
はぁ、はぁ……このあともね……お姉ちゃん、もっと、もっとしたいの……ご主人様ぁ……甘えてもいいかなぁ……？	후~, 후~……이후에도……언니, 좀 더, 좀 더 하고 싶은 것……주인님……응석부려도 괜찮을까……?
え？　健康診断？　まったく心当たりがないんだけど……	에? 건강검진? 전혀 짚이는 것이 없지만……
きゃああああっ！？　何見てんのよ！　ありえない！　信じられない！　ばかばかばかっ！	꺄아아아앗!? 뭘 보고있는거얏! 말도안되! 믿을수가 없어! 바보바보바봇!
ははは、今日はエイプリルフールだよ。	하하하, 오늘은 만우절이야.
なっ……！？　あ、そうか……くぅ、悪趣味よ。女の子のトップシークレットを何だと思ってるのよ。	뭣……!? 아, 그런가…… 큿, 악취미야. 여자의 일급 비밀을 뭐라고 생각하는거야.
べ、別に、その……ご主人様なんか意識してないけど……体重は、うぅっ……	벼, 별로, 그…… 주인님같은건 의식하지 않았지만…… 체중은, 우으으……
……そんなに？	……그렇게나?
違うのよ！　ただ知られたくないの！　ばか！	그런게 아니야! 그냥 알려주기 싫은거야! 바보!
ご主人様、アタシ、今日誕生日なの。	주인님, 나 오늘 생일이야.
あれっ？　そうだったっけ？　ごめん、忘れてて……	어랏? 그랬던가? 미안, 잊어 버려서……
別にいいわよ。でも、今からどこかに遊びに行きたいの。だめ？	별로 신경쓰지마. 그래도, 지금부터 어딘가로 놀라가고 싶어. 안돼?
わかった。行くよ。準備しよう。	알겠어. 가자. 준비한다.
まあ、嘘なんだけどね……。	뭐, 거짓말이지만 말이지…….
ん？　何か言った？	응? 뭔가 말했어?
今日誕生日っていうのだけ、嘘よ。さ、アタシも準備するから、早く行きましょ？	오늘 생일이라는거, 거짓말이야. 그럼, 나도 준비할테니까, 얼른 갈까요?
……ねぇ、ご主人様。メイド秘書から聞いていると思うのだけれど……	……저기, 주인님. 메이드 비서에게 들었다고 생각하지만……
私……猫カフェのオーナーになろうと思って、しばらくの間、勉強する時間が欲しいの。	나…… 고양이 카페의 주인이 되려고 생각해서, 한동안, 공부할 시간이 필요해.
ごめん、ご主人様。私も色々考えたのだけれど……	미안, 주인님. 저도 여러가지 생각했지만……
私は本気。にゃんにゃんしたいの……	나는 진심이야. 냥냥 하고 싶은거야……
そう……。ふふっ、ふふふっ……	그래……. 후훗, 후후훗……
いいえ、そうじゃなくて。今日、何の日だか覚えているかしら。	아녜요, 그게 아니라. 오늘이, 무슨날인지 기억하고 있을까.
……何の日？　えっと…………あっ！	……무슨날? 그러니까…… 앗!
そう、エイプリルフールよ。というわけで、さっきのは嘘だから。それじゃあね、ご主人様。	그래, 만우절이야. 그런거니까, 아까 그건 거짓말이니까. 그럼, 주인님.
え？　なにかしら、ご主人様。	에? 무슨일일까, 주인님.
隠し事とは聞き捨てならないけれど……なにかしら？	숨기고 있던 일이라니 흘려 넘길수는 없겠네…… 무슨일일까?
……もしかしてご主人様、それってエイプリルフールの嘘のつもりかしら？	……혹시 주인님, 그거 만우절 거짓말을 할 속셈인거야?
…………え？	…………에?
私が、その程度の嘘も見抜けないとでも？　私はご主人様の専属なのよ。	내가, 그 정도의 거짓말도 눈치채지 못할거라고? 나는 주인님의 전속이에요.
あ、えっと……はい、嘘です。ごめんなさい。	아, 그게…… 네, 거짓말이에요. 미안합니다.
……それに、もし仮にご主人様が不治の病にかかっていたとしても、私が一生面倒見るから問題ないわ。	……게다가, 말일 주인님이 불치병을 앓고 있다고 해도, 내가 평생 돌볼거기 때문에 문제없어.
だって私は、ご主人様の専属メイドであり、恋人なのだから。それくらい、当然でしょう？	왜냐면 나는, 주인님의 전속 메이드이자, 연인이니까. 그정도는, 당연하겠죠?
ええ……っ！　どうしましょう、わたし……！　あっ、いますぐ、病院の手配を……！	에엣……! 어쩌죠, 저……! 앗, 지금당장, 병원을 알아봐야……!
なんてね、嘘だよ。エイプリルフール。	랄까, 거짓말이야. 만우절이니까.
え……と、嘘、ですか……？　じゃあ、ちゃんと治る病気なんですね、よかった……！　でも病院には、行ったほうがいいですよ？	에……엣, 거짓말, 입니까……? 그럼, 제대로 나았다는 말이네요, 다행이다……! 그래도, 병원에는 가보는 것이 좋아요?
あ、いや、そうじゃないよ。病気にかかったっていうのが、そもそも嘘で……	아, 아니, 그게 아니야. 병에 걸렸다는 것부터, 애초에 거짓말이야……
あ……、そういう、ことだったんですね……。ごめんなさい、わたし、理解が遅くて……	아……, 그런 것이었군요……. 미안해요, 저, 이해하는게 늦어서……
いやいや。そもそもエイプリルフールだからって嘘をついた俺も悪いから。気にしないでよ。	아니아니. 원래 만우절이라고 거짓말을 한 나도 나쁘니까. 신경 쓰지 말아요.
ご、ご主人様に、気を使わせてしまうなんて……！　わたし、嘘の勉強してきます……！	주, 주인님에게, 걱정을 끼쳐 버리다니……! 저, 거짓말의 공부를 하고 오겠습니다……!
ご主人様、今日って実は、４月２日なんですよっ！	주인님, 오늘은 사실, 4월 2일 이에요!
……え？　今日は、４月１日だよ？	……뭐? 오늘은, 4월 1일 인데?
ええと、だから……っ、……ごめんなさい、面白くなかった、ですよね……	그그게, 그러니……까, ……미안해요, 재미 없었다, 그렇죠……
うーん……流れがよくわからないんだけど、どういうこと？	으음…… 흐름을 잘 모르겠지만, 무슨말이야?
いえ、今日はエイプリルフールなので、何か気の利いた嘘をと思ったんですけど……ごめんなさい、考えなおしてきます……！	아니요, 오늘은 만우절이라, 뭔가 재미있는 거짓말이라 생각했는데…… 미안해요, 다시 생각해 오겠습니다……
そ、そうなんですか……？　ほっ……、すこし、安心しました……	그, 그렇습니까……? 아주……, 살짝, 안심했습니다……
ご主人様、どうかしましたか？　お顔色が優れませんよ？	주인님, 무슨일 있으세요? 안색이 좋지 않아요?
え……ええと、昨日の夜、お隣さんが逮捕されちゃってさ。大変だったんだ。	에…… 그러니까, 어젯밤에, 이웃이 체포되서 말이야. 큰일이였어.
あら……どうしてですか？　何か、強盗とかですか？	어머…… 왜요? 뭔가, 강도같은 겁니까?
えー……その人の彼氏が浮気してたみたいでさ。ナイフで女性を刺しちゃったんだよ。	에-…… 그사람의 남자친구가 바람핀것 같아서 말이야. 나이프로 여자를 찔러버린 거야.
しかも人が見てる所でやっちゃって。事情聴取とかで眠れなくて……	게다가 사람들이 보는 장소에서 저질러 버려서. 사정청취라던가로 잠을 못자서……
……ご主人様、それ、嘘ですよね？　もう……本当は、何をしていたんですか？	……주인님, 그거, 거짓말이죠? 정말…… 사실은, 무엇을 하고 있었습니까?
う……ゲームして徹夜しちゃって……エイプリルフールだから、嘘ついてみようと思って。	으…… 게임하느라 밤을 새버려서…… 만우절이니까, 거짓말을 해보자 생각해서.
でも、よく嘘だってわかったね。	그래도, 잘도 거짓말이라는걸 알았네.
だって、普通は彼氏だけ刺すでしょう？　女の人も刺したら、彼氏と女の人が同じ病室になるかもしれないじゃないですか……	왜냐면, 보통은 남자친구만 찌르죠? 여자도 찔러버리면, 남자친구와 여자가 같은 병실이 될지도 모르잖아요……
ご主人様、私、実は、月の一度の、その……アレが……	주인님, 저, 사실은, 달마다 하는, 저기…… 그게……
えっ、ほんとに？　ええと、どうすれば……	엣, 정말? 그그게, 어떻게 하면……
……うふふ、嘘ですよ。エイプリルフールですよ、今日は。	……우후훗, 거짓말이에요. 오늘은, 만우절이에요.
あっ、そうか。びっくりした……	앗, 그렇구나. 깜짝 놀랐다……
ふふ、ごめんなさい。でも、そんなに驚かせてしまうとは思いませんでした。	후훗, 미안합니다. 하지만, 그렇게 놀라게 해버릴거라고는 생각하지 못했어요.
そりゃあ、びっくりするよ……酔って記憶が無かったあの夜とか……	그거야, 놀라버리지…… 취해서 필름이 끊어져 버렸던 그날밤이나……
もしそうなら、私なら子供を産んだ後に報告します。	만약 그렇다면, 저라면 아이를 낳은 다음에 보고합니다.
え……そうなの？　どうして？	에…… 그런거야? 어째서?
……ふふ、そうなってしまえば……あ、いえ、何でもありませんよ、ご主人様？	……후훗, 그렇게 해버리면…… 아, 아니, 아무것도 아니에요, 주인님?
えっ？　なぁに、ご主人様。なにかご用？	어?　에, 주인님. 무엇인가 용건?
実は俺、有名な女優さんと交際する事になったんだけどさ……相手がすごいもんだから緊張して。なにかアドバイスとかないかな？	실은 나, 유명한 여배우와 교제하는 일이 되었지만 ……상대가 대단한 것이니까 긴장해. 무엇인가 어드바이스라든지 없을까?
…………それ、本当？	…………그것, 사실?
な、なに、その疑いの眼差しは……	, 뭐, 그 혐의의 시선은……
ご主人様、嘘つく時の目してるよ。	주인님, 거짓말 할 때의 눈 하고 있어.
そ、そそそ、そんな事ないんじゃないかなぁ。	, 솔솔, 그런 일 없지 않을까.
私の目をきちんと見て、もう一度同じ事が言えるかな？	나의 눈을 제대로 봐, 한번 더 같은 일을 말할 수 있을까?
…………ご、ごめんなさい、嘘です。	…………, 미안해요, 거짓말입니다.
ほらぁ、やっぱりぃ。どうせ嘘をつくなら、人を幸せにする嘘をつかなきゃダメだよ。めっ！	이봐요, 역시. 어차피 거짓말한다면, 사람을 행복하게 하는 거짓말하지 않으면 안되어. 째!
えっ、本当！？　すごい、ご主人様って天使だったんだ……！	어, 사실!　대단히, 주인 같다는 것은 천사였다……!
あ、あぁ、実はそうなんだ。	아, 아, 실은 그렇구나.
すごぉい！　じゃあ、羽根とか生えるのかなっ？　天使の輪っかとかは！？	있고!　자, 날개라든지 나는지?　천사의 고리라든지는!
そうなんだぁ、残念……。せっかくご主人様にお姫様抱っこしてもらって、お空を飛んでみたかったのにぃ……	그렇구나, 유감……. 모처럼 주인님에게 공주님 안기 받아, 하늘을 날아 보고 싶었는데  ……
じゃあじゃあ、神様は？　神様には会った事があるのかな！　お姉ちゃん、気になるよ……！	좍좍, 신님는?　신님에는 만난 일이 있는 것일까!　언니, 신경이 쓰여……!
うん、それはね……	응, 그것은요……
あ、あの……どうかな、この下着……えへへ……は、恥ずかしいなぁ、こういうの。	저, 저기…… 어떨까나, 이런 속옷…… 에헤헤…… 부, 부끄럽네, 이런거.
なんていうか、その、さ……これってエッチな事でしか使えないじゃない、非生産的よね……	뭐랄까, 그게, 말야…… 이런건 H한 일 외에는 쓸 수 없잖아, 비생산적네요……
すごく似合うよ。	굉장히 잘어울려.
複雑な気分なんだけど。あ、あう……ご主人様ったら、もうおっきくしてる……そんなにアタシの恰好に興奮しちゃってるわけ？	복잡한 기분이 드는데. 아, 아우…… 주인님도 참, 벌써 커다래 져선…… 그렇게 내 모습에 흥분해 버리는 거야?
ふふ、勇気を出して着てきてよかったかも。ご主人様が発情してる……アタシ、これからいっぱいご主人様に夜伽してもらえるんだ……	후후, 용기를 내서 입어본게 다행이였네. 주인님이 발정하고 있어…… 나, 지금부터 잔뜩 주인님에게 밤시중을 받을 수 있구나……
確かに、着替えてる時はドキドキしたけど……この下着をつけたら吹っ切れちゃったかも？　ふふ、エッチな顔したご主人様を想像したら、ちょっと楽しくなってきちゃって。	확실히, 갈아입을 때는 두근두근 했지만…… 이 속옷을 입고나니 개운해져 버렸을지도? 후후, H한 얼굴을 하고있는 주인님을 상상하니, 조금 즐거워져 버려서.
……その、アタシ……大胆な夜伽もできちゃうかも？　エッチな言葉を言ったり、エッチにご主人様を誘ったり、ね。	……저기, 나…… 대담한 밤시중도 할 수 있을지도? H한 말을 하거나, H하게 주인님을 유혹하거나, 말이야.
さ、ほら……その。この下着だったら、アソコがもうヌルヌルになってるの、気づかれちゃったかな……？　はやく、可愛がって？　エッチして？　ご主人様……	그, 이봐…… 그게. 이 속옷이라면, 거기가 벌써 촉촉해져 버린걸, 알아차려 버렸을까……? 빨리 귀여워해줘? H해줘? 주인님……
ああ、分かったよ。	아아, 알았어요.
ご主人様、着替えてみたのだけど……、な、何……？　そんな、じろじろ見て……	주인님, 갈아입고 왔는데……, 뭐, 뭐야……? 그렇게, 빤히 쳐다보고……
ほ、本当に……？　私としては、こんな……何も隠せてない下着、恥ずかしいのだけど……	저, 정말로……? 저로서는, 이런…… 아무것도 가리지 않는 속옷, 부끄러운데 말야……
ほんとに似合ってるよ。ほら、これ。	굉장이 잘어울려. 봐봐, 이거.
あ……、ご主人様の、大きく……！　本当に、私でここまで……？　ふふ、そう思うと、着たかいがあったかしら……	아……, 주인님의, 커다랗게……! 정말, 저때문에 이렇게……? 후후, 그렇게 생각하면, 입은 보람이 있을까요……
ええ……なんだか、褒められると、嫌な気分はしないわ……。恥ずかしいけれど、でも、なんだか、気持ちが良いわ……、ご主人様の言う、エッチな気分……かも。	에에…… 뭔가, 칭찬을 받으면, 싫은 기분은 들지 않아……. 부끄럽지만, 그래도, 왠지, 기분이 좋아……, 주인님이 말한, H한 기분 일지도.
なんだか、ここまでしてしまうと、もっと振りきれてしまいそう。もう少しエッチな言葉を言ってみたり、大胆な……夜伽をしたり、とか。	왠지, 여기까지 해버리면, 한발 더 나아갈 수 있을것 같아. 조금 더 야한 말을 이야기해보거나, 대담한…… 밤시중을 하거나, 말이야.
そ、そう……？　軽い、冗談のつもりだったのだけれど……、ふふ、でも、いいわ。大胆にしてあげる……	그, 그래……? 가벼운, 농담을 할 생각이었지만……, 후후, 그래도, 좋아요. 대담하게 해줄게……
それで……ご主人様、いつ、するの……？　私、なんだか今日は……早く、ご主人様と一つになりたい気分なの……。夜伽、するんでしょう……？	그래서…… 주인님, 언제, 하는거야……? 나, 왠지 오늘은…… 빨리, 주인님과 하나가 되고 싶은 기분이야……. 밤시중 하는거죠……?
ああ、いいよ。早く行こう。	아아, 좋아. 빨리 가자.
ご……ご主人様、着替え、終わりました……！　ど、どうですか……？	주…… 주인님, 갈아입는 거, 다했어요……! 어, 어때요……?
そ……！　そんなこと、言わないでください……っ！　その、着替えてる時に、もうわかってましたから……	그……! 그런 밀, 하지 말아 주세요……! 저기, 옷을 갈아입을 때, 이미 알았으니까요……
へえ、途中でわかってたのに、着てくれたんだ？	헤에, 도중에 알았는데도, 입어줬구나?
は、はい……っ、ご主人様が、喜んでくれるかと思って……、どうですか……？　やっぱり、わたしには似合わないですか……？	네, 넷……! 주인님이, 기뻐해 주실까 생각해서…… 어때요……? 역시, 저한테는 안 어울리나요……?
そう、ですよね……っ！　ご主人様の、すごい、元気になって……、ふふ、なんだか、うれしいです……！　わたしで、興奮してくれたんですよね……？	그런, 가요……! 주인님의 거기, 엄청, 건강해져서…… 후후, 왠지, 기뻐요……! 저로, 흥분해주신 거네요……?
そうだよ。でも、なんか今日は積極的だね？	그래. 근데, 뭔가 오늘은 적극적이네?
あ……！　そう、ですか……？　ごめんなさい、この服を頑張って着た時に、なんだか、変に自信が出てきて……、なんでだろう……？	아……! 그런, 가요……? 죄송해요. 이 옷을 힘내서 입었을 때, 왠지, 이상하게 자신감이 생겨서…… 왜 그렇지……?
いや、悪く言ってるんじゃないんだ。むしろ、嬉しいよ。	아니, 나쁘게 말하려는 게 아니야. 오히려 기뻐.
ほ、ほんとですか……？　なんだか、わたし、今日は大胆な夜伽もできちゃいそうな気がします……！　普段言えないエッチな言葉とかも、今なら……！	저, 정말인가요……? 왠지, 저, 오늘은 대담한 밤시중도 할 수 있을 것 같은 기분이에요……! 평소에는 못 하는 야한 말도, 지금은……!
あの……ご主人様も、はやく、したいですよね……？　わたし……早くご主人様に、この姿で……可愛がって、欲しいです……っ、だめ、ですか……？	저기…… 주인님도, 빨리 하고싶은 거죠……? 저…… 빨리 주인님에게, 이 모습으로…… 귀여움 받고, 싶어요……! 안되, 나요……?
うん、いいよ。じゃあ、行こうか。	응, 좋아. 그럼, 갈까?
ご主人様……、これ、どうですか？	주인님……, 이거, 어떻습니까?
おお、似合ってるよ。	오오, 잘어울려요.
ほ、本当ですか……？　うふふ、ご主人様にそう言っていただけると、わたくしも嬉しいです……！	저, 정말입니까……? 우후후, 주인님에게 그렇게 말해주시면, 저도 기쁩니다……!
でも、すごい丸見えだね。恥ずかしくない？	그래도, 너무 훤히 보이네. 부끄럽지 않아?
恥ずかしいですけど、ご主人様だけに見せるものですから。そういうご主人様も、大きくなってるのを隠せていませんよ？	부끄럽지만, 주인님만 보는 것이니까. 그렇게 말하는 주인님도, 커다래지는 것을 감추지 않았어요?
ぁあ……ご主人様、可愛いです……っ、わたくし、なんだか体があつくなってきました……	아아…… 주인님, 사랑스럽습니다……ㅅ, 저, 왠지 몸이 더워졌습니다……
うふふ、ありがとうございます……！　わたくし、なんだか今日は、大胆になれそうです……！	우후후, 감사합니다……! 저, 왠지 오늘은, 대담하게 될 것 같아요……!
ご主人様が言って欲しければ、淫らな言葉で……ご、ご主人様の為に……ふふ……ご主人様も、たくさんわたくしのことを愛してくれすよね……？	주인님이 말해주기 바라신다면, 음란한 말로…… 주, 주인님을 위해서…… 후후…… 주인님도, 잔뜩 저를 사랑해주실거죠……?
もう……っご主人様、早く行きましょう……？　わたくし、もうご主人様が欲しくて、たまらないんです……！	이제……ㅅ 주인님, 빨리 갑시다……? 전, 벌써 주인님을 원해서, 참을수가 없어요……!
わかった、じゃあ、行こうか。	알았어, 그럼, 가볼까?
じゃ、じゃーん……っ！　ご主人様、どうかな……？　ちょっと、いやらしすぎる、かな……？	그러면, 그러면-응……!　주인님 아무쪼록인……?　좀, 너무 불쾌한, 일까……?
確かにそうだけど、すごく似合ってるよ。	확실히 그렇지만, 몹시 어울리고 있어.
よ、よかったぁ……っ、着替えるとき、すごくドキドキしたんだよ……？　こんな、えっちな下着……どこも、隠せなくて……	, 좋았다……, 갈아입을 때, 몹시 두근두근 했어……?　이런, 인 속옷……어디도, 숨길 수 없어서……
でも、似合ってるって言われると、なんだか嬉しいなぁっ……！　それに、その……ご主人様も、元気になってるみたいだしぃ……、そんなの、見せられたら……	그렇지만, 어울리고 있다고 말해지면(자), 어쩐지 기쁘다 ……!　게다가, 그……주인님도, 건강하게 되고 있는 것 같고 ……, 그런 것, 보여지면(자)……
大胆になっちゃう？	대담하게 되어버리는?
なっちゃう、かもぉ……っ。ふふっ、ねえ、ご主人様……？　これから、夜伽……するんだよね？	되어버린다, 일지도 ……. 후후, 응, 주인님……?　지금부터, 밤시중……해?
そうだけど、どうして？	그렇지만, 어째서?
こんなえっちな格好してると、いつも通りっていう感じじゃなくて……私も、ちょっと大胆に、えっちに……夜伽、したいなって……。どうかな？	이런 인 모습 하고 있으면, 언제나 대로라고 하는 느낌이 아니고……나도, 조금 대담하게, 에……밤시중, 하고 싶다는……. 어떨까?
うふふ、そう言ってくれると思ってた。ほらほら、そうと決まれば早く行きましょ？　今日はいっぱい、えっちなお姉ちゃんを見せてあげるから……ね？	후후, 그렇게 말해 준다고 생각했다. 이봐요 이봐요, 그렇다고 정해지면 빨리 갑시다?　오늘은 가득, 더 언니(누나) 를 보여 주기 때문……?
うん、楽しみだよ。	응, 기다려져.
