デスクアイテム	데스크 아이템
ヘルプ	도움말
UI位置初期化	UI 위치 초기화
クリスマスツリー	크리스마스 트리
カドマツ	카도마츠
マグカップ	머그컵
スマホスタンドA	스마트폰 스탠드 A
スマホスタンドB	스마트폰 스탠드 B
オフィシャルファンブック	오피셜 팬북
ねい人形	네이인형
ロボねい人形	로봇 네이인형
参考書A（閉）	참고서 A(덮힘)
参考書B（閉）	참고서 B(덮힘)
参考書C（閉）	참고서 C(덮힘)
参考書D（閉）	참고서 D(덮힘)
参考書E（閉）	참고서 E(덮힘)
鉛筆（緑）	연필(초록)
消しゴム（青）	지우개(파랑)
ペン（黒）	샤프(검정)
スティック糊	딱풀
表示する	표시한다
特定期間のみ表示する(1月)	특정기간에만 표시한다 (1월)
特定期間のみ表示する(12月)	특정기간에만 표시한다 (12월)
軸の表示設定	축 표시설정
移動軸	이동축
回転軸	회전축
軸表示なし	표시안함
位置	위치
回転	회전
拡縮	크기
倍率	배율
リセット	리셋
コピー	복사
ペースト	붙여넣기
